＃＃＃＃＃＃＃＃＃＃＃＃＃＃＃＃＃＃＃＃＃＃＃＃＃＃＃＃＃＃＃＃＃＃＃＃＃＃＃＃＃＃＃＃＃＃＃＃＃＃＃＃＃＃＃＃＃＃＃＃＃＃＃＃＃＃＃＃＃＃＃＃＃＃＃＃＃＃＃＃＃＃＃＃＃＃＃＃＃＃＃＃＃＃＃＃＃＃＃＃＃＃＃＃＃＃＃＃＃＃＃＃＃＃＃＃＃＃＃＃＃＃＃＃＃＃＃＃＃＃＃＃＃＃＃＃＃＃＃＃＃＃＃＃＃＃＃
＃＃＃＃＃＃＃＃＃＃＃＃＃＃＃＃＃＃＃＃＃＃＃＃＃＃＃＃＃＃＃＃＃＃＃＃＃＃＃＃＃＃＃＃＃＃＃＃＃＃＃＃＃＃＃＃＃＃＃＃＃＃＃＃＃＃＃＃＃＃＃＃＃＃＃＃＃＃＃＃＃＃＃＃＃＃＃＃＃＃＃＃＃＃＃＃＃＃＃＃＃＃＃＃＃＃＃＃＃＃＃＃＃＃＃＃＃＃＃＃＃＃＃＃＃＃＃＃＃＃＃＃＃＃＃＃＃＃＃＃＃＃＃＃＃＃＃
＃＃＃＃＃＃＃＃＃＃＃＃＃＃＃＃＃＃＃＃＃＃＃＃＃＃＃＃＃＃＃＃＃＃＃＃＃＃＃＃＃＃＃＃＃＃＃＃＃＃＃＃＃＃＃＃＃＃＃＃＃＃＃＃＃＃＃＃＃＃＃＃＃＃＃＃＃＃＃＃＃＃＃＃＃＃＃＃＃＃＃＃＃＃＃＃＃＃＃＃＃＃＃＃＃＃＃＃＃＃＃＃＃＃＃＃＃＃＃＃＃＃＃＃＃＃＃＃＃＃＃＃＃＃＃＃＃＃＃＃＃＃＃＃＃＃＃
＃＃＃＃＃＃＃＃＃＃＃＃＃＃＃＃＃＃＃＃＃＃＃＃＃＃＃＃＃＃＃＃＃＃＃＃＃＃＃＃＃＃＃＃＃＃＃＃＃＃＃＃＃＃＃＃＃＃＃＃＃＃＃＃＃＃＃＃＃＃＃＃＃＃＃＃＃＃＃＃＃＃＃＃＃＃＃＃＃＃＃＃＃＃＃＃＃＃＃＄＄＄＄＄＄＄＄＄＄＄＄＄＄＄＄＄＄＄＄＄＄＄＄＄＄＄＄＄＄＄＄＄＄＄＄＄＄＄＄＄＄＄＄＄＃＃＃
＃＃＃＃＃＃＃＃＃＃＃＃＃＃＃＃＃＃＃＃＃＃＃＃＃＃＃＃＃＃＃＃＃＃＃＃＃＃＃＃＃＃＃＃＃＃＃＃＃＃＃＃＃＃＃＃＃＃＃＃＃＃＃＃＃＃＃＃＃＃＃＃＃＃＃＃＃＃＃＃＃＃＃＃＃＃＃＃＃＃＃＃＃＃＃＃＃＃＃＄＄＄＄＄＄＄＄＄＄＄＄＄＄＄＄＄＄＄＄＄＄＄＄＄＄＄＄＄＄＄＄＄＄＄＄＄＄＄＄＄＄＄＄＄＃＃＃
＃＃＃＃＃＃＃＃＃＃＃＃＃＃＃＃＃＃＃＃＃＃＃＃＃＃＃＃＃＃＃＃＃＃＃＃＃＃＃＃＃＃＃＃＃＃＃＃＃＃＃＃＃＃＃＃＃＃＃＃＃＃＃＃＃＃＃＃＃＃＃＃＃＃＃＃＃＃＃＃＃＃＃＃＃＃＃＃＃＃＃＃＃＃＃＃＃＃＃＄＄＄＄＄＄＄＄＄＄＄＄＄＄＄＄＄＄＄＄＄＄＄＄＄＄＄＄＄＄＄＄＄＄＄＄＄＄＄＄＄＄＄＄＄＃＃＃
＃＃＃＠＠＠＠＠＠＠＠＠＃＃＃＄＄＄＄＄＄＄＄＄＄＄＄＄＄＄＄＄＄＄＄＄＄＄＄＄＄＄＄＄＄＄＄＄＄＄＄＃＃＃＄＄＄＄＄＄＄＄＄＄＄＄＄＄＄＃＃＃＃＃＃＃＃＃＃＃＃＃＃＃＃＃＃＃＃＃＃＃＃＃＃＃＃＃＃＄＄＄＃＃＃＃＃＃＃＃＃＄＄＄＃＃＃＃＃＃＃＃＃＃＃＃＃＃＃＃＃＃＃＃＃＄＄＄＃＃＃＄＄＄＃＃＃
＃＃＃＠＠＠＠＠＠＠＠＠＃＃＃＄＄＄＄＄＄＄＄＄＄＄＄＄＄＄＄＄＄＄＄＄＄＄＄＄＄＄＄＄＄＄＄＄＄＄＄＃＃＃＄＄＄＄＄＄＄＄＄＄＄＄＄＄＄＃＃＃＃＃＃＃＃＃＠＠＠＠＠＠＃＃＃＃＃＃＃＃＃＃＃＃＃＃＃＄＄＄＃＃＃＃＃＃＃＃＃＄＄＄＃＃＃＃＃＃＃＃＃＃＃＃＃＃＃＃＃＃＃＃＃＄＄＄＃＃＃＄＄＄＃＃＃
＃＃＃＠＠＠＠＠＠＠＠＠＃＃＃＄＄＄＄＄＄＄＄＄＄＄＄＄＄＄＄＄＄＄＄＄＄＄＄＄＄＄＄＄＄＄＄＄＄＄＄＃＃＃＄＄＄＄＄＄＄＄＄＄＄＄＄＄＄＃＃＃＃＃＃＃＃＃＠＠＠＠＠＠＃＃＃＃＃＃＃＃＃＃＃＃＃＃＃＄＄＄＃＃＃＃＃＃＃＃＃＄＄＄＃＃＃＃＃＃＃＃＃＃＃＃＃＃＃＃＃＃＃＃＃＄＄＄＃＃＃＄＄＄＃＃＃
＃＃＃＠＠＠＠＠＠＠＠＠＃＃＃＄＄＄＃＃＃＄＄＄＃＃＃＄＄＄＃＃＃＄＄＄＃＃＃＄＄＄＃＃＃＄＄＄＄＄＄＃＃＃＄＄＄＃＃＃＃＃＃＃＃＃＄＄＄＃＃＃＃＃＃＃＃＃＠＠＠＠＠＠＃＃＃＠＠＠＠＠＠＠＠＠＃＃＃＄＄＄＄＄＄＄＄＄＄＄＄＄＄＄＃＃＃＄＄＄＄＄＄＄＄＄＄＄＄＄＄＄＄＄＄＄＄＄＃＃＃＄＄＄＃＃＃
＃＃＃＠＠＠＠＠＠＠＠＠＃＃＃＄＄＄＃＃＃＄＄＄＃＃＃＄＄＄＃＃＃＄＄＄＃＃＃＄＄＄＃＃＃＄＄＄＄＄＄＃＃＃＄＄＄＃＃＃＃＃＃＃＃＃＄＄＄＃＃＃＃＃＃＃＃＃＠＠＠＠＠＠＃＃＃＠＠＠＠＠＠＠＠＠＃＃＃＄＄＄＄＄＄＄＄＄＄＄＄＄＄＄＃＃＃＄＄＄＄＄＄＄＄＄＄＄＄＄＄＄＄＄＄＄＄＄＃＃＃＄＄＄＃＃＃
＃＃＃＠＠＠＠＠＠＠＠＠＃＃＃＄＄＄＃＃＃＄＄＄＃＃＃＄＄＄＃＃＃＄＄＄＃＃＃＄＄＄＃＃＃＄＄＄＄＄＄＃＃＃＄＄＄＃＃＃＃＃＃＃＃＃＄＄＄＃＃＃＃＃＃＃＃＃＠＠＠＠＠＠＃＃＃＠＠＠＠＠＠＠＠＠＃＃＃＄＄＄＄＄＄＄＄＄＄＄＄＄＄＄＃＃＃＄＄＄＄＄＄＄＄＄＄＄＄＄＄＄＄＄＄＄＄＄＃＃＃＄＄＄＃＃＃
＃＃＃＠＠＠＠＠＠＠＠＠＃＃＃＄＄＄＃＃＃＄＄＄＃＃＃＄＄＄＃＃＃＄＄＄＃＃＃＄＄＄＃＃＃＄＄＄＄＄＄＃＃＃＄＄＄＄＄＄＄＄＄＃＃＃＄＄＄＃＃＃＃＃＃＃＃＃＠＠＠＠＠＠＃＃＃＠＠＠＠＠＠＠＠＠＃＃＃＄＄＄＃＃＃＃＃＃＃＃＃＄＄＄＃＃＃＄＄＄＃＃＃＃＃＃＃＃＃＄＄＄＃＃＃＃＃＃＃＃＃＄＄＄＃＃＃
＃＃＃＠＠＠＠＠＠＠＠＠＃＃＃＄＄＄＃＃＃＄＄＄＃＃＃＄＄＄＃＃＃＄＄＄＃＃＃＄＄＄＃＃＃＄＄＄＄＄＄＃＃＃＄＄＄＄＄＄＄＄＄＃＃＃＄＄＄＃＃＃＃＃＃＃＃＃＠＠＠＠＠＠＃＃＃＠＠＠＠＠＠＠＠＠＃＃＃＄＄＄＃＃＃＃＃＃＃＃＃＄＄＄＃＃＃＄＄＄＃＃＃＃＃＃＃＃＃＄＄＄＃＃＃＃＃＃＃＃＃＄＄＄＃＃＃
＃＃＃＠＠＠＠＠＠＠＠＠＃＃＃＄＄＄＃＃＃＄＄＄＃＃＃＄＄＄＃＃＃＄＄＄＃＃＃＄＄＄＃＃＃＄＄＄＄＄＄＃＃＃＄＄＄＄＄＄＄＄＄＃＃＃＄＄＄＃＃＃＃＃＃＃＃＃＠＠＠＠＠＠＃＃＃＠＠＠＠＠＠＠＠＠＃＃＃＄＄＄＃＃＃＃＃＃＃＃＃＄＄＄＃＃＃＄＄＄＃＃＃＃＃＃＃＃＃＄＄＄＃＃＃＃＃＃＃＃＃＄＄＄＃＃＃
＃＃＃＠＠＠＃＃＃＃＃＃＃＃＃＄＄＄＃＃＃＄＄＄＃＃＃＄＄＄＃＃＃＄＄＄＃＃＃＄＄＄＃＃＃＄＄＄＄＄＄＃＃＃＃＃＃＃＃＃＄＄＄＃＃＃＄＄＄＃＃＃＃＃＃＃＃＃＄＄＄＄＄＄＃＃＃＠＠＠＠＠＠＠＠＠＃＃＃＄＄＄＄＄＄＄＄＄＄＄＄＄＄＄＄＄＄＄＄＄＃＃＃＄＄＄＄＄＄＄＄＄＄＄＄＄＄＄＃＃＃＄＄＄＃＃＃
＃＃＃＠＠＠＃＃＃＃＃＃＃＃＃＄＄＄＃＃＃＄＄＄＃＃＃＄＄＄＃＃＃＄＄＄＃＃＃＄＄＄＃＃＃＄＄＄＄＄＄＃＃＃＃＃＃＃＃＃＄＄＄＃＃＃＄＄＄＃＃＃＃＃＃＃＃＃＄＄＄＄＄＄＃＃＃＠＠＠＠＠＠＠＠＠＃＃＃＄＄＄＄＄＄＄＄＄＄＄＄＄＄＄＄＄＄＄＄＄＃＃＃＄＄＄＄＄＄＄＄＄＄＄＄＄＄＄＃＃＃＄＄＄＃＃＃
＃＃＃＠＠＠＃＃＃＃＃＃＃＃＃＄＄＄＃＃＃＄＄＄＃＃＃＄＄＄＃＃＃＄＄＄＃＃＃＄＄＄＃＃＃＄＄＄＄＄＄＃＃＃＃＃＃＃＃＃＄＄＄＃＃＃＄＄＄＃＃＃＃＃＃＃＃＃＄＄＄＄＄＄＃＃＃＠＠＠＠＠＠＠＠＠＃＃＃＄＄＄＄＄＄＄＄＄＄＄＄＄＄＄＄＄＄＄＄＄＃＃＃＄＄＄＄＄＄＄＄＄＄＄＄＄＄＄＃＃＃＄＄＄＃＃＃
＃＃＃＄＄＄＄＄＄＄＄＄＄＄＄＄＄＄＄＄＄＄＄＄＄＄＄＄＄＄＄＄＄＄＄＄＄＄＄＄＄＄＄＄＄＄＄＄＄＄＄＃＃＃＄＄＄＄＄＄＄＄＄＃＃＃＄＄＄＃＃＃＃＃＃＃＃＃＄＄＄＄＄＄＃＃＃＠＠＠＃＃＃＃＃＃＃＃＃＄＄＄＃＃＃＄＄＄＃＃＃＃＃＃＃＃＃＄＄＄＃＃＃＄＄＄＃＃＃＃＃＃＃＃＃＄＄＄＃＃＃＄＄＄＃＃＃
＃＃＃＄＄＄＄＄＄＄＄＄＄＄＄＄＄＄＄＄＄＄＄＄＄＄＄＄＄＄＄＄＄＄＄＄＄＄＄＄＄＄＄＄＄＄＄＄＄＄＄＃＃＃＄＄＄＄＄＄＄＄＄＃＃＃＄＄＄＃＃＃＃＃＃＃＃＃＄＄＄＄＄＄＃＃＃＠＠＠＃＃＃＃＃＃＃＃＃＄＄＄＃＃＃＄＄＄＃＃＃＃＃＃＃＃＃＄＄＄＃＃＃＄＄＄＃＃＃＃＃＃＃＃＃＄＄＄＃＃＃＄＄＄＃＃＃
＃＃＃＄＄＄＄＄＄＄＄＄＄＄＄＄＄＄＄＄＄＄＄＄＄＄＄＄＄＄＄＄＄＄＄＄＄＄＄＄＄＄＄＄＄＄＄＄＄＄＄＃＃＃＄＄＄＄＄＄＄＄＄＃＃＃＄＄＄＃＃＃＃＃＃＃＃＃＄＄＄＄＄＄＃＃＃＠＠＠＃＃＃＃＃＃＃＃＃＄＄＄＃＃＃＄＄＄＃＃＃＃＃＃＃＃＃＄＄＄＃＃＃＄＄＄＃＃＃＃＃＃＃＃＃＄＄＄＃＃＃＄＄＄＃＃＃
＃＃＃＄＄＄＄＄＄＄＄＄＄＄＄＄＄＄＄＄＄＄＄＄＄＄＄＄＄＄＄＄＄＄＄＄＄＄＄＄＄＄＄＄＄＄＄＄＄＄＄＃＃＃＄＄＄＃＃＃＃＃＃＃＃＃＄＄＄＃＃＃＃＃＃＃＃＃＄＄＄＄＄＄＃＃＃＄＄＄＄＄＄＄＄＄＄＄＄＄＄＄＃＃＃＄＄＄＄＄＄＄＄＄＄＄＄＄＄＄＄＄＄＄＄＄＄＄＄＄＄＄＃＃＃＄＄＄＃＃＃＄＄＄＃＃＃
＃＃＃＄＄＄＄＄＄＄＄＄＄＄＄＄＄＄＄＄＄＄＄＄＄＄＄＄＄＄＄＄＄＄＄＄＄＄＄＄＄＄＄＄＄＄＄＄＄＄＄＃＃＃＄＄＄＃＃＃＃＃＃＃＃＃＄＄＄＃＃＃＃＃＃＃＃＃＄＄＄＄＄＄＃＃＃＄＄＄＄＄＄＄＄＄＄＄＄＄＄＄＃＃＃＄＄＄＄＄＄＄＄＄＄＄＄＄＄＄＄＄＄＄＄＄＄＄＄＄＄＄＃＃＃＄＄＄＃＃＃＄＄＄＃＃＃
＃＃＃＄＄＄＄＄＄＄＄＄＄＄＄＄＄＄＄＄＄＄＄＄＄＄＄＄＄＄＄＄＄＄＄＄＄＄＄＄＄＄＄＄＄＄＄＄＄＄＄＃＃＃＄＄＄＃＃＃＃＃＃＃＃＃＄＄＄＃＃＃＃＃＃＃＃＃＄＄＄＄＄＄＃＃＃＄＄＄＄＄＄＄＄＄＄＄＄＄＄＄＃＃＃＄＄＄＄＄＄＄＄＄＄＄＄＄＄＄＄＄＄＄＄＄＄＄＄＄＄＄＃＃＃＄＄＄＃＃＃＄＄＄＃＃＃
＃＃＃＄＄＄＃＃＃＃＃＃＃＃＃＃＃＃＃＃＃＃＃＃＃＃＃＃＃＃＃＃＃＃＃＃＃＃＃＃＃＃＃＃＃＄＄＄＄＄＄＃＃＃＄＄＄＄＄＄＄＄＄＃＃＃＄＄＄＃＃＃＃＃＃＃＃＃＄＄＄＄＄＄＃＃＃＃＃＃＃＃＃＄＄＄＃＃＃＄＄＄＃＃＃＃＃＃＃＃＃＄＄＄＃＃＃＄＄＄＃＃＃＃＃＃＃＃＃＄＄＄＃＃＃＄＄＄＃＃＃＄＄＄＃＃＃
＃＃＃＄＄＄＃＃＃＃＃＃＃＃＃＃＃＃＃＃＃＃＃＃＃＃＃＃＃＃＃＃＃＃＃＃＃＃＃＃＃＃＃＃＃＄＄＄＄＄＄＃＃＃＄＄＄＄＄＄＄＄＄＃＃＃＄＄＄＃＃＃＃＃＃＃＃＃＄＄＄＄＄＄＃＃＃＃＃＃＃＃＃＄＄＄＃＃＃＄＄＄＃＃＃＃＃＃＃＃＃＄＄＄＃＃＃＄＄＄＃＃＃＃＃＃＃＃＃＄＄＄＃＃＃＄＄＄＃＃＃＄＄＄＃＃＃
＃＃＃＄＄＄＃＃＃＃＃＃＃＃＃＃＃＃＃＃＃＃＃＃＃＃＃＃＃＃＃＃＃＃＃＃＃＃＃＃＃＃＃＃＃＄＄＄＄＄＄＃＃＃＄＄＄＄＄＄＄＄＄＃＃＃＄＄＄＃＃＃＃＃＃＃＃＃＄＄＄＄＄＄＃＃＃＃＃＃＃＃＃＄＄＄＃＃＃＄＄＄＃＃＃＃＃＃＃＃＃＄＄＄＃＃＃＄＄＄＃＃＃＃＃＃＃＃＃＄＄＄＃＃＃＄＄＄＃＃＃＄＄＄＃＃＃
＃＃＃＄＄＄＄＄＄＄＄＄＄＄＄＄＄＄＄＄＄＄＄＄＄＄＄＄＄＄＄＄＄＄＄＄＄＄＄＄＄＄＄＄＄＄＄＄＄＄＄＃＃＃＃＃＃＃＃＃＄＄＄＃＃＃＄＄＄＃＃＃＃＃＃＃＃＃＄＄＄＄＄＄＃＃＃＄＄＄＄＄＄＄＄＄＃＃＃＄＄＄＄＄＄＄＄＄＄＄＄＄＄＄＃＃＃＄＄＄＄＄＄＄＄＄＄＄＄＄＄＄＄＄＄＄＄＄＃＃＃＄＄＄＃＃＃
＃＃＃＄＄＄＄＄＄＄＄＄＄＄＄＄＄＄＄＄＄＄＄＄＄＄＄＄＄＄＄＄＄＄＄＄＄＄＄＄＄＄＄＄＄＄＄＄＄＄＄＃＃＃＃＃＃＃＃＃＄＄＄＃＃＃＄＄＄＃＃＃＃＃＃＃＃＃＄＄＄＄＄＄＃＃＃＄＄＄＄＄＄＄＄＄＃＃＃＄＄＄＄＄＄＄＄＄＄＄＄＄＄＄＃＃＃＄＄＄＄＄＄＄＄＄＄＄＄＄＄＄＄＄＄＄＄＄＃＃＃＄＄＄＃＃＃
＃＃＃＄＄＄＄＄＄＄＄＄＄＄＄＄＄＄＄＄＄＄＄＄＄＄＄＄＄＄＄＄＄＄＄＄＄＄＄＄＄＄＄＄＄＄＄＄＄＄＄＃＃＃＃＃＃＃＃＃＄＄＄＃＃＃＄＄＄＃＃＃＃＃＃＃＃＃＄＄＄＄＄＄＃＃＃＄＄＄＄＄＄＄＄＄＃＃＃＄＄＄＄＄＄＄＄＄＄＄＄＄＄＄＃＃＃＄＄＄＄＄＄＄＄＄＄＄＄＄＄＄＄＄＄＄＄＄＃＃＃＄＄＄＃＃＃
＃＃＃＃＃＃＃＃＃＃＃＃＃＃＃＃＃＃＃＃＃＃＃＃＃＃＃＃＃＃＃＃＃＃＃＃＃＃＃＠＠＠＃＃＃＄＄＄＄＄＄＃＃＃＃＃＃＃＃＃＄＄＄＄＄＄＄＄＄＃＃＃＃＃＃＃＃＃＄＄＄＄＄＄＃＃＃＄＄＄＃＃＃＃＃＃＃＃＃＄＄＄＃＃＃＄＄＄＃＃＃＄＄＄＃＃＃＄＄＄＃＃＃＄＄＄＃＃＃＄＄＄＃＃＃＄＄＄＃＃＃＄＄＄＃＃＃
＃＃＃＃＃＃＃＃＃＃＃＃＃＃＃＃＃＃＃＃＃＃＃＃＃＃＃＃＃＃＃＃＃＃＃＃＃＃＃＠＠＠＃＃＃＄＄＄＄＄＄＃＃＃＃＃＃＃＃＃＄＄＄＄＄＄＄＄＄＃＃＃＃＃＃＃＃＃＄＄＄＄＄＄＃＃＃＄＄＄＃＃＃＃＃＃＃＃＃＄＄＄＃＃＃＄＄＄＃＃＃＄＄＄＃＃＃＄＄＄＃＃＃＄＄＄＃＃＃＄＄＄＃＃＃＄＄＄＃＃＃＄＄＄＃＃＃
＃＃＃＃＃＃＃＃＃＃＃＃＃＃＃＃＃＃＃＃＃＃＃＃＃＃＃＃＃＃＃＃＃＃＃＃＃＃＃＠＠＠＃＃＃＄＄＄＄＄＄＃＃＃＃＃＃＃＃＃＄＄＄＄＄＄＄＄＄＃＃＃＃＃＃＃＃＃＄＄＄＄＄＄＃＃＃＄＄＄＃＃＃＃＃＃＃＃＃＄＄＄＃＃＃＄＄＄＃＃＃＄＄＄＃＃＃＄＄＄＃＃＃＄＄＄＃＃＃＄＄＄＃＃＃＄＄＄＃＃＃＄＄＄＃＃＃
＃＃＃＄＄＄＄＄＄＄＄＄＄＄＄＄＄＄＄＄＄＄＄＄＄＄＄＄＄＄＄＄＄＄＄＄＄＄＄＄＄＄＃＃＃＄＄＄＄＄＄＃＃＃＃＃＃＃＃＃＃＃＃＃＃＃＄＄＄＃＃＃＃＃＃＃＃＃＄＄＄＄＄＄＃＃＃＄＄＄＄＄＄＄＄＄＄＄＄＄＄＄＄＄＄＄＄＄＃＃＃＄＄＄＄＄＄＄＄＄＃＃＃＄＄＄＃＃＃＄＄＄＄＄＄＄＄＄＃＃＃＄＄＄＃＃＃
＃＃＃＄＄＄＄＄＄＄＄＄＄＄＄＄＄＄＄＄＄＄＄＄＄＄＄＄＄＄＄＄＄＄＄＄＄＄＄＄＄＄＃＃＃＄＄＄＄＄＄＃＃＃＃＃＃＃＃＃＃＃＃＃＃＃＄＄＄＃＃＃＃＃＃＃＃＃＄＄＄＄＄＄＃＃＃＄＄＄＄＄＄＄＄＄＄＄＄＄＄＄＄＄＄＄＄＄＃＃＃＄＄＄＄＄＄＄＄＄＃＃＃＄＄＄＃＃＃＄＄＄＄＄＄＄＄＄＃＃＃＄＄＄＃＃＃
＃＃＃＄＄＄＄＄＄＄＄＄＄＄＄＄＄＄＄＄＄＄＄＄＄＄＄＄＄＄＄＄＄＄＄＄＄＄＄＄＄＄＃＃＃＄＄＄＄＄＄＃＃＃＃＃＃＃＃＃＃＃＃＃＃＃＄＄＄＃＃＃＃＃＃＃＃＃＄＄＄＄＄＄＃＃＃＄＄＄＄＄＄＄＄＄＄＄＄＄＄＄＄＄＄＄＄＄＃＃＃＄＄＄＄＄＄＄＄＄＃＃＃＄＄＄＃＃＃＄＄＄＄＄＄＄＄＄＃＃＃＄＄＄＃＃＃
＃＃＃＄＄＄＃＃＃＄＄＄＃＃＃＄＄＄＃＃＃＄＄＄＃＃＃＄＄＄＃＃＃＄＄＄＃＃＃＄＄＄＃＃＃＄＄＄＄＄＄＃＃＃＠＠＠＠＠＠＠＠＠＃＃＃＄＄＄＃＃＃＃＃＃＃＃＃＄＄＄＄＄＄＃＃＃＃＃＃＃＃＃＄＄＄＃＃＃＃＃＃＃＃＃＄＄＄＃＃＃＄＄＄＃＃＃＄＄＄＃＃＃＄＄＄＃＃＃＄＄＄＃＃＃＄＄＄＃＃＃＄＄＄＃＃＃
＃＃＃＄＄＄＃＃＃＄＄＄＃＃＃＄＄＄＃＃＃＄＄＄＃＃＃＄＄＄＃＃＃＄＄＄＃＃＃＄＄＄＃＃＃＄＄＄＄＄＄＃＃＃＠＠＠＠＠＠＠＠＠＃＃＃＄＄＄＃＃＃＃＃＃＃＃＃＄＄＄＄＄＄＃＃＃＃＃＃＃＃＃＄＄＄＃＃＃＃＃＃＃＃＃＄＄＄＃＃＃＄＄＄＃＃＃＄＄＄＃＃＃＄＄＄＃＃＃＄＄＄＃＃＃＄＄＄＃＃＃＄＄＄＃＃＃
＃＃＃＄＄＄＃＃＃＄＄＄＃＃＃＄＄＄＃＃＃＄＄＄＃＃＃＄＄＄＃＃＃＄＄＄＃＃＃＄＄＄＃＃＃＄＄＄＄＄＄＃＃＃＠＠＠＠＠＠＠＠＠＃＃＃＄＄＄＃＃＃＃＃＃＃＃＃＄＄＄＄＄＄＃＃＃＃＃＃＃＃＃＄＄＄＃＃＃＃＃＃＃＃＃＄＄＄＃＃＃＄＄＄＃＃＃＄＄＄＃＃＃＄＄＄＃＃＃＄＄＄＃＃＃＄＄＄＃＃＃＄＄＄＃＃＃
＃＃＃＄＄＄＄＄＄＄＄＄＄＄＄＄＄＄＄＄＄＄＄＄＄＄＄＄＄＄＄＄＄＄＄＄＄＄＄＄＄＄＃＃＃＄＄＄＄＄＄＠＠＠＠＠＠＠＠＠＠＠＠＃＃＃＄＄＄＃＃＃＃＃＃＃＃＃＄＄＄＄＄＄＠＠＠＄＄＄＄＄＄＄＄＄＃＃＃＄＄＄＄＄＄＄＄＄＃＃＃＄＄＄＄＄＄＄＄＄＄＄＄＄＄＄＃＃＃＄＄＄＃＃＃＄＄＄＃＃＃＄＄＄＃＃＃
＃＃＃＄＄＄＄＄＄＄＄＄＄＄＄＄＄＄＄＄＄＄＄＄＄＄＄＄＄＄＄＄＄＄＄＄＄＄＄＄＄＄＃＃＃＄＄＄＄＄＄＠＠＠＠＠＠＠＠＠＠＠＠＃＃＃＄＄＄＃＃＃＃＃＃＃＃＃＄＄＄＄＄＄＠＠＠＄＄＄＄＄＄＄＄＄＃＃＃＄＄＄＄＄＄＄＄＄＃＃＃＄＄＄＄＄＄＄＄＄＄＄＄＄＄＄＃＃＃＄＄＄＃＃＃＄＄＄＃＃＃＄＄＄＃＃＃
＃＃＃＄＄＄＄＄＄＄＄＄＄＄＄＄＄＄＄＄＄＄＄＄＄＄＄＄＄＄＄＄＄＄＄＄＄＄＄＄＄＄＃＃＃＄＄＄＄＄＄＠＠＠＠＠＠＠＠＠＠＠＠＃＃＃＄＄＄＃＃＃＃＃＃＃＃＃＄＄＄＄＄＄＠＠＠＄＄＄＄＄＄＄＄＄＃＃＃＄＄＄＄＄＄＄＄＄＃＃＃＄＄＄＄＄＄＄＄＄＄＄＄＄＄＄＃＃＃＄＄＄＃＃＃＄＄＄＃＃＃＄＄＄＃＃＃
＃＃＃＄＄＄＃＃＃＄＄＄＃＃＃＄＄＄＃＃＃＄＄＄＃＃＃＄＄＄＃＃＃＄＄＄＃＃＃＄＄＄＃＃＃＄＄＄＄＄＄＃＃＃＠＠＠＠＠＠＠＠＠＃＃＃＄＄＄＃＃＃＃＃＃＃＃＃＄＄＄＄＄＄＃＃＃＄＄＄＃＃＃＄＄＄＃＃＃＄＄＄＃＃＃＃＃＃＃＃＃＃＃＃＃＃＃＄＄＄＃＃＃＃＃＃＃＃＃＄＄＄＃＃＃＄＄＄＃＃＃＄＄＄＃＃＃
＃＃＃＄＄＄＃＃＃＄＄＄＃＃＃＄＄＄＃＃＃＄＄＄＃＃＃＄＄＄＃＃＃＄＄＄＃＃＃＄＄＄＃＃＃＄＄＄＄＄＄＃＃＃＠＠＠＠＠＠＠＠＠＃＃＃＄＄＄＃＃＃＃＃＃＃＃＃＄＄＄＄＄＄＃＃＃＄＄＄＃＃＃＄＄＄＃＃＃＄＄＄＃＃＃＃＃＃＃＃＃＃＃＃＃＃＃＄＄＄＃＃＃＃＃＃＃＃＃＄＄＄＃＃＃＄＄＄＃＃＃＄＄＄＃＃＃
＃＃＃＄＄＄＃＃＃＄＄＄＃＃＃＄＄＄＃＃＃＄＄＄＃＃＃＄＄＄＃＃＃＄＄＄＃＃＃＄＄＄＃＃＃＄＄＄＄＄＄＃＃＃＠＠＠＠＠＠＠＠＠＃＃＃＄＄＄＃＃＃＃＃＃＃＃＃＄＄＄＄＄＄＃＃＃＄＄＄＃＃＃＄＄＄＃＃＃＄＄＄＃＃＃＃＃＃＃＃＃＃＃＃＃＃＃＄＄＄＃＃＃＃＃＃＃＃＃＄＄＄＃＃＃＄＄＄＃＃＃＄＄＄＃＃＃
＃＃＃＄＄＄＄＄＄＄＄＄＄＄＄＄＄＄＄＄＄＄＄＄＄＄＄＄＄＄＄＄＄＄＄＄＄＄＄＄＄＄＃＃＃＄＄＄＄＄＄＃＃＃＃＃＃＃＃＃＃＃＃＃＃＃＄＄＄＃＃＃＃＃＃＃＃＃＄＄＄＄＄＄＃＃＃＄＄＄＄＄＄＄＄＄＄＄＄＄＄＄＄＄＄＄＄＄＄＄＄＄＄＄＄＄＄＄＄＄＄＄＄＄＄＄＄＄＄＄＄＄＃＃＃＄＄＄＄＄＄＄＄＄＃＃＃
＃＃＃＄＄＄＄＄＄＄＄＄＄＄＄＄＄＄＄＄＄＄＄＄＄＄＄＄＄＄＄＄＄＄＄＄＄＄＄＄＄＄＃＃＃＄＄＄＄＄＄＃＃＃＃＃＃＃＃＃＃＃＃＃＃＃＄＄＄＃＃＃＃＃＃＃＃＃＄＄＄＄＄＄＃＃＃＄＄＄＄＄＄＄＄＄＄＄＄＄＄＄＄＄＄＄＄＄＄＄＄＄＄＄＄＄＄＄＄＄＄＄＄＄＄＄＄＄＄＄＄＄＃＃＃＄＄＄＄＄＄＄＄＄＃＃＃
＃＃＃＄＄＄＄＄＄＄＄＄＄＄＄＄＄＄＄＄＄＄＄＄＄＄＄＄＄＄＄＄＄＄＄＄＄＄＄＄＄＄＃＃＃＄＄＄＄＄＄＃＃＃＃＃＃＃＃＃＃＃＃＃＃＃＄＄＄＃＃＃＃＃＃＃＃＃＄＄＄＄＄＄＃＃＃＄＄＄＄＄＄＄＄＄＄＄＄＄＄＄＄＄＄＄＄＄＄＄＄＄＄＄＄＄＄＄＄＄＄＄＄＄＄＄＄＄＄＄＄＄＃＃＃＄＄＄＄＄＄＄＄＄＃＃＃
＃＃＃＠＠＠＃＃＃＠＠＠＃＃＃＠＠＠＃＃＃＠＠＠＃＃＃＠＠＠＃＃＃＠＠＠＃＃＃＠＠＠＃＃＃＠＠＠＠＠＠＃＃＃＃＃＃＃＃＃＃＃＃＃＃＃＄＄＄＃＃＃＃＃＃＃＃＃＄＄＄＄＄＄＃＃＃＃＃＃＃＃＃＃＃＃＃＃＃＃＃＃＃＃＃＃＃＃＃＃＃＃＃＃＃＃＃＃＃＃＃＃＃＃＃＃＃＃＃＃＃＃＃＃＃＠＠＠＃＃＃＃＃＃＃＃＃
＃＃＃＠＠＠＃＃＃＠＠＠＃＃＃＠＠＠＃＃＃＠＠＠＃＃＃＠＠＠＃＃＃＠＠＠＃＃＃＠＠＠＃＃＃＠＠＠＠＠＠＃＃＃＃＃＃＃＃＃＃＃＃＃＃＃＄＄＄＃＃＃＃＃＃＃＃＃＄＄＄＄＄＄＃＃＃＃＃＃＃＃＃＃＃＃＃＃＃＃＃＃＃＃＃＃＃＃＃＃＃＃＃＃＃＃＃＃＃＃＃＃＃＃＃＃＃＃＃＃＃＃＃＃＃＠＠＠＃＃＃＃＃＃＃＃＃
＃＃＃＠＠＠＃＃＃＠＠＠＃＃＃＠＠＠＃＃＃＠＠＠＃＃＃＠＠＠＃＃＃＠＠＠＃＃＃＠＠＠＃＃＃＠＠＠＠＠＠＃＃＃＃＃＃＃＃＃＃＃＃＃＃＃＄＄＄＃＃＃＃＃＃＃＃＃＄＄＄＄＄＄＃＃＃＃＃＃＃＃＃＃＃＃＃＃＃＃＃＃＃＃＃＃＃＃＃＃＃＃＃＃＃＃＃＃＃＃＃＃＃＃＃＃＃＃＃＃＃＃＃＃＃＠＠＠＃＃＃＃＃＃＃＃＃
＃＃＃＄＄＄＄＄＄＄＄＄＄＄＄＄＄＄＄＄＄＄＄＄＄＄＄＄＄＄＄＄＄＄＄＄＄＄＄＄＄＄＄＄＄＄＄＄＄＄＄＄＄＄＄＄＄＄＄＄＄＄＄＠＠＠＄＄＄＄＄＄＄＄＄＠＠＠＄＄＄＄＄＄＄＄＄＄＄＄＄＄＄＄＄＄＄＄＄＄＄＄＄＄＄＄＄＄＄＄＄＄＄＄＄＄＄＄＄＄＄＄＄＄＄＄＄＄＄＄＄＄＄＄＄＄＄＄＄＄＄＄＄＄＃＃＃
＃＃＃＄＄＄＄＄＄＄＄＄＄＄＄＄＄＄＄＄＄＄＄＄＄＄＄＄＄＄＄＄＄＄＄＄＄＄＄＄＄＄＄＄＄＄＄＄＄＄＄＄＄＄＄＄＄＄＄＄＄＄＄＠＠＠＄＄＄＄＄＄＄＄＄＠＠＠＄＄＄＄＄＄＄＄＄＄＄＄＄＄＄＄＄＄＄＄＄＄＄＄＄＄＄＄＄＄＄＄＄＄＄＄＄＄＄＄＄＄＄＄＄＄＄＄＄＄＄＄＄＄＄＄＄＄＄＄＄＄＄＄＄＄＃＃＃
＃＃＃＄＄＄＄＄＄＄＄＄＄＄＄＄＄＄＄＄＄＄＄＄＄＄＄＄＄＄＄＄＄＄＄＄＄＄＄＄＄＄＄＄＄＄＄＄＄＄＄＄＄＄＄＄＄＄＄＄＄＄＄＠＠＠＄＄＄＄＄＄＄＄＄＠＠＠＄＄＄＄＄＄＄＄＄＄＄＄＄＄＄＄＄＄＄＄＄＄＄＄＄＄＄＄＄＄＄＄＄＄＄＄＄＄＄＄＄＄＄＄＄＄＄＄＄＄＄＄＄＄＄＄＄＄＄＄＄＄＄＄＄＄＃＃＃
＃＃＃＄＄＄＄＄＄＄＄＄＄＄＄＄＄＄＄＄＄＄＄＄＄＄＄＄＄＄＄＄＄＄＄＄＄＄＄＄＄＄＄＄＄＄＄＄＄＄＄＄＄＄＄＄＄＄＄＄＄＄＄＠＠＠＠＠＠＠＠＠＄＄＄＠＠＠＠＠＠＠＠＠＄＄＄＄＄＄＄＄＄＄＄＄＄＄＄＄＄＄＄＄＄＄＄＄＄＄＄＄＄＄＄＄＄＄＄＄＄＄＄＄＄＄＄＄＄＄＄＄＄＄＄＄＄＄＄＄＄＄＄＄＃＃＃
＃＃＃＄＄＄＄＄＄＄＄＄＄＄＄＄＄＄＄＄＄＄＄＄＄＄＄＄＄＄＄＄＄＄＄＄＄＄＄＄＄＄＄＄＄＄＄＄＄＄＄＄＄＄＄＄＄＄＄＄＄＄＄＠＠＠＠＠＠＠＠＠＄＄＄＠＠＠＠＠＠＠＠＠＄＄＄＄＄＄＄＄＄＄＄＄＄＄＄＄＄＄＄＄＄＄＄＄＄＄＄＄＄＄＄＄＄＄＄＄＄＄＄＄＄＄＄＄＄＄＄＄＄＄＄＄＄＄＄＄＄＄＄＄＃＃＃
＃＃＃＄＄＄＄＄＄＄＄＄＄＄＄＄＄＄＄＄＄＄＄＄＄＄＄＄＄＄＄＄＄＄＄＄＄＄＄＄＄＄＄＄＄＄＄＄＄＄＄＄＄＄＄＄＄＄＄＄＄＄＄＠＠＠＠＠＠＠＠＠＄＄＄＠＠＠＠＠＠＠＠＠＄＄＄＄＄＄＄＄＄＄＄＄＄＄＄＄＄＄＄＄＄＄＄＄＄＄＄＄＄＄＄＄＄＄＄＄＄＄＄＄＄＄＄＄＄＄＄＄＄＄＄＄＄＄＄＄＄＄＄＄＃＃＃
＃＃＃＄＄＄＄＄＄＄＄＄＄＄＄＄＄＄＄＄＄＄＄＄＄＄＄＄＄＄＄＄＄＄＄＄＄＄＄＄＄＄＄＄＄＄＄＄＄＄＄＄＄＄＄＄＄＄＄＄＄＄＄＄＄＄＄＄＄＠＠＠＄＄＄＄＄＄＄＄＄＠＠＠＄＄＄＄＄＄＄＄＄＄＄＄＄＄＄＄＄＄＄＄＄＄＄＄＄＄＄＄＄＄＄＄＄＄＄＄＄＄＄＄＄＄＄＄＄＄＄＄＄＄＄＄＄＄＄＄＄＄＄＄＃＃＃
＃＃＃＄＄＄＄＄＄＄＄＄＄＄＄＄＄＄＄＄＄＄＄＄＄＄＄＄＄＄＄＄＄＄＄＄＄＄＄＄＄＄＄＄＄＄＄＄＄＄＄＄＄＄＄＄＄＄＄＄＄＄＄＄＄＄＄＄＄＠＠＠＄＄＄＄＄＄＄＄＄＠＠＠＄＄＄＄＄＄＄＄＄＄＄＄＄＄＄＄＄＄＄＄＄＄＄＄＄＄＄＄＄＄＄＄＄＄＄＄＄＄＄＄＄＄＄＄＄＄＄＄＄＄＄＄＄＄＄＄＄＄＄＄＃＃＃
＃＃＃＄＄＄＄＄＄＄＄＄＄＄＄＄＄＄＄＄＄＄＄＄＄＄＄＄＄＄＄＄＄＄＄＄＄＄＄＄＄＄＄＄＄＄＄＄＄＄＄＄＄＄＄＄＄＄＄＄＄＄＄＄＄＄＄＄＄＠＠＠＄＄＄＄＄＄＄＄＄＠＠＠＄＄＄＄＄＄＄＄＄＄＄＄＄＄＄＄＄＄＄＄＄＄＄＄＄＄＄＄＄＄＄＄＄＄＄＄＄＄＄＄＄＄＄＄＄＄＄＄＄＄＄＄＄＄＄＄＄＄＄＄＃＃＃
＃＃＃＃＃＃＃＃＃＠＠＠＃＃＃＃＃＃＃＃＃＃＃＃＃＃＃＃＃＃＃＃＃＃＃＃＃＃＃＃＃＃＃＃＃＃＃＃＃＃＃＃＃＃＃＃＃＃＃＃＃＃＃＄＄＄＄＄＄＃＃＃＃＃＃＃＃＃＄＄＄＃＃＃＃＃＃＃＃＃＃＃＃＃＃＃＠＠＠＠＠＠＃＃＃＠＠＠＃＃＃＠＠＠＃＃＃＠＠＠＃＃＃＠＠＠＃＃＃＠＠＠＃＃＃＠＠＠＃＃＃＠＠＠＃＃＃
＃＃＃＃＃＃＃＃＃＠＠＠＃＃＃＃＃＃＃＃＃＃＃＃＃＃＃＃＃＃＃＃＃＃＃＃＃＃＃＃＃＃＃＃＃＃＃＃＃＃＃＃＃＃＃＃＃＃＃＃＃＃＃＄＄＄＄＄＄＃＃＃＃＃＃＃＃＃＄＄＄＃＃＃＃＃＃＃＃＃＃＃＃＃＃＃＠＠＠＠＠＠＃＃＃＠＠＠＃＃＃＠＠＠＃＃＃＠＠＠＃＃＃＠＠＠＃＃＃＠＠＠＃＃＃＠＠＠＃＃＃＠＠＠＃＃＃
＃＃＃＃＃＃＃＃＃＠＠＠＃＃＃＃＃＃＃＃＃＃＃＃＃＃＃＃＃＃＃＃＃＃＃＃＃＃＃＃＃＃＃＃＃＃＃＃＃＃＃＃＃＃＃＃＃＃＃＃＃＃＃＄＄＄＄＄＄＃＃＃＃＃＃＃＃＃＄＄＄＃＃＃＃＃＃＃＃＃＃＃＃＃＃＃＠＠＠＠＠＠＃＃＃＠＠＠＃＃＃＠＠＠＃＃＃＠＠＠＃＃＃＠＠＠＃＃＃＠＠＠＃＃＃＠＠＠＃＃＃＠＠＠＃＃＃
＃＃＃＄＄＄＄＄＄＄＄＄＃＃＃＄＄＄＄＄＄＄＄＄＄＄＄＄＄＄＄＄＄＄＄＄＄＄＄＄＄＄＄＄＄＄＄＄＄＄＄＄＄＄＄＄＄＄＄＄＃＃＃＄＄＄＄＄＄＃＃＃＃＃＃＃＃＃＄＄＄＃＃＃＃＃＃＃＃＃＃＃＃＃＃＃＄＄＄＄＄＄＃＃＃＄＄＄＄＄＄＄＄＄＄＄＄＄＄＄＄＄＄＄＄＄＄＄＄＄＄＄＄＄＄＄＄＄＄＄＄＄＄＄＃＃＃
＃＃＃＄＄＄＄＄＄＄＄＄＃＃＃＄＄＄＄＄＄＄＄＄＄＄＄＄＄＄＄＄＄＄＄＄＄＄＄＄＄＄＄＄＄＄＄＄＄＄＄＄＄＄＄＄＄＄＄＄＃＃＃＄＄＄＄＄＄＃＃＃＃＃＃＃＃＃＄＄＄＃＃＃＃＃＃＃＃＃＃＃＃＃＃＃＄＄＄＄＄＄＃＃＃＄＄＄＄＄＄＄＄＄＄＄＄＄＄＄＄＄＄＄＄＄＄＄＄＄＄＄＄＄＄＄＄＄＄＄＄＄＄＄＃＃＃
＃＃＃＄＄＄＄＄＄＄＄＄＃＃＃＄＄＄＄＄＄＄＄＄＄＄＄＄＄＄＄＄＄＄＄＄＄＄＄＄＄＄＄＄＄＄＄＄＄＄＄＄＄＄＄＄＄＄＄＄＃＃＃＄＄＄＄＄＄＃＃＃＃＃＃＃＃＃＄＄＄＃＃＃＃＃＃＃＃＃＃＃＃＃＃＃＄＄＄＄＄＄＃＃＃＄＄＄＄＄＄＄＄＄＄＄＄＄＄＄＄＄＄＄＄＄＄＄＄＄＄＄＄＄＄＄＄＄＄＄＄＄＄＄＃＃＃
＃＃＃＄＄＄＃＃＃＄＄＄＃＃＃＄＄＄＃＃＃＃＃＃＃＃＃＄＄＄＃＃＃＃＃＃＃＃＃＃＃＃＃＃＃＄＄＄＃＃＃＄＄＄＃＃＃＄＄＄＃＃＃＄＄＄＄＄＄＃＃＃＃＃＃＃＃＃＄＄＄＃＃＃＠＠＠＠＠＠＠＠＠＃＃＃＄＄＄＄＄＄＃＃＃＄＄＄＃＃＃＄＄＄＃＃＃＄＄＄＃＃＃＄＄＄＃＃＃＄＄＄＃＃＃＄＄＄＃＃＃＄＄＄＃＃＃
＃＃＃＄＄＄＃＃＃＄＄＄＃＃＃＄＄＄＃＃＃＃＃＃＃＃＃＄＄＄＃＃＃＃＃＃＃＃＃＃＃＃＃＃＃＄＄＄＃＃＃＄＄＄＃＃＃＄＄＄＃＃＃＄＄＄＄＄＄＃＃＃＃＃＃＃＃＃＄＄＄＃＃＃＠＠＠＠＠＠＠＠＠＃＃＃＄＄＄＄＄＄＃＃＃＄＄＄＃＃＃＄＄＄＃＃＃＄＄＄＃＃＃＄＄＄＃＃＃＄＄＄＃＃＃＄＄＄＃＃＃＄＄＄＃＃＃
＃＃＃＄＄＄＃＃＃＄＄＄＃＃＃＄＄＄＃＃＃＃＃＃＃＃＃＄＄＄＃＃＃＃＃＃＃＃＃＃＃＃＃＃＃＄＄＄＃＃＃＄＄＄＃＃＃＄＄＄＃＃＃＄＄＄＄＄＄＃＃＃＃＃＃＃＃＃＄＄＄＃＃＃＠＠＠＠＠＠＠＠＠＃＃＃＄＄＄＄＄＄＃＃＃＄＄＄＃＃＃＄＄＄＃＃＃＄＄＄＃＃＃＄＄＄＃＃＃＄＄＄＃＃＃＄＄＄＃＃＃＄＄＄＃＃＃
＃＃＃＄＄＄＃＃＃＄＄＄＃＃＃＄＄＄＃＃＃＄＄＄＄＄＄＄＄＄＄＄＄＄＄＄＃＃＃＄＄＄＄＄＄＄＄＄＃＃＃＄＄＄＄＄＄＄＄＄＠＠＠＄＄＄＄＄＄＃＃＃＃＃＃＃＃＃＄＄＄＃＃＃＠＠＠＠＠＠＠＠＠＠＠＠＄＄＄＄＄＄＃＃＃＄＄＄＄＄＄＄＄＄＄＄＄＄＄＄＄＄＄＄＄＄＄＄＄＄＄＄＄＄＄＄＄＄＄＄＄＄＄＄＃＃＃
＃＃＃＄＄＄＃＃＃＄＄＄＃＃＃＄＄＄＃＃＃＄＄＄＄＄＄＄＄＄＄＄＄＄＄＄＃＃＃＄＄＄＄＄＄＄＄＄＃＃＃＄＄＄＄＄＄＄＄＄＠＠＠＄＄＄＄＄＄＃＃＃＃＃＃＃＃＃＄＄＄＃＃＃＠＠＠＠＠＠＠＠＠＠＠＠＄＄＄＄＄＄＃＃＃＄＄＄＄＄＄＄＄＄＄＄＄＄＄＄＄＄＄＄＄＄＄＄＄＄＄＄＄＄＄＄＄＄＄＄＄＄＄＄＃＃＃
＃＃＃＄＄＄＃＃＃＄＄＄＃＃＃＄＄＄＃＃＃＄＄＄＄＄＄＄＄＄＄＄＄＄＄＄＃＃＃＄＄＄＄＄＄＄＄＄＃＃＃＄＄＄＄＄＄＄＄＄＠＠＠＄＄＄＄＄＄＃＃＃＃＃＃＃＃＃＄＄＄＃＃＃＠＠＠＠＠＠＠＠＠＠＠＠＄＄＄＄＄＄＃＃＃＄＄＄＄＄＄＄＄＄＄＄＄＄＄＄＄＄＄＄＄＄＄＄＄＄＄＄＄＄＄＄＄＄＄＄＄＄＄＄＃＃＃
＃＃＃＄＄＄＃＃＃＄＄＄＃＃＃＄＄＄＃＃＃＄＄＄＃＃＃＄＄＄＃＃＃＄＄＄＃＃＃＄＄＄＃＃＃＃＃＃＃＃＃＄＄＄＃＃＃＃＃＃＃＃＃＄＄＄＄＄＄＃＃＃＃＃＃＃＃＃＄＄＄＃＃＃＠＠＠＠＠＠＠＠＠＃＃＃＄＄＄＄＄＄＃＃＃＄＄＄＃＃＃＄＄＄＃＃＃＄＄＄＃＃＃＄＄＄＃＃＃＄＄＄＃＃＃＄＄＄＃＃＃＄＄＄＃＃＃
＃＃＃＄＄＄＃＃＃＄＄＄＃＃＃＄＄＄＃＃＃＄＄＄＃＃＃＄＄＄＃＃＃＄＄＄＃＃＃＄＄＄＃＃＃＃＃＃＃＃＃＄＄＄＃＃＃＃＃＃＃＃＃＄＄＄＄＄＄＃＃＃＃＃＃＃＃＃＄＄＄＃＃＃＠＠＠＠＠＠＠＠＠＃＃＃＄＄＄＄＄＄＃＃＃＄＄＄＃＃＃＄＄＄＃＃＃＄＄＄＃＃＃＄＄＄＃＃＃＄＄＄＃＃＃＄＄＄＃＃＃＄＄＄＃＃＃
＃＃＃＄＄＄＃＃＃＄＄＄＃＃＃＄＄＄＃＃＃＄＄＄＃＃＃＄＄＄＃＃＃＄＄＄＃＃＃＄＄＄＃＃＃＃＃＃＃＃＃＄＄＄＃＃＃＃＃＃＃＃＃＄＄＄＄＄＄＃＃＃＃＃＃＃＃＃＄＄＄＃＃＃＠＠＠＠＠＠＠＠＠＃＃＃＄＄＄＄＄＄＃＃＃＄＄＄＃＃＃＄＄＄＃＃＃＄＄＄＃＃＃＄＄＄＃＃＃＄＄＄＃＃＃＄＄＄＃＃＃＄＄＄＃＃＃
＃＃＃＄＄＄＃＃＃＄＄＄＄＄＄＄＄＄＃＃＃＄＄＄＃＃＃＄＄＄＄＄＄＄＄＄＃＃＃＄＄＄＄＄＄＄＄＄＄＄＄＄＄＄＄＄＄＄＄＄＃＃＃＄＄＄＄＄＄＃＃＃＃＃＃＃＃＃＄＄＄＃＃＃＃＃＃＃＃＃＃＃＃＃＃＃＄＄＄＄＄＄＃＃＃＄＄＄＄＄＄＄＄＄＄＄＄＄＄＄＄＄＄＄＄＄＄＄＄＄＄＄＄＄＄＄＄＄＄＄＄＄＄＄＃＃＃
＃＃＃＄＄＄＃＃＃＄＄＄＄＄＄＄＄＄＃＃＃＄＄＄＃＃＃＄＄＄＄＄＄＄＄＄＃＃＃＄＄＄＄＄＄＄＄＄＄＄＄＄＄＄＄＄＄＄＄＄＃＃＃＄＄＄＄＄＄＃＃＃＃＃＃＃＃＃＄＄＄＃＃＃＃＃＃＃＃＃＃＃＃＃＃＃＄＄＄＄＄＄＃＃＃＄＄＄＄＄＄＄＄＄＄＄＄＄＄＄＄＄＄＄＄＄＄＄＄＄＄＄＄＄＄＄＄＄＄＄＄＄＄＄＃＃＃
＃＃＃＄＄＄＃＃＃＄＄＄＄＄＄＄＄＄＃＃＃＄＄＄＃＃＃＄＄＄＄＄＄＄＄＄＃＃＃＄＄＄＄＄＄＄＄＄＄＄＄＄＄＄＄＄＄＄＄＄＃＃＃＄＄＄＄＄＄＃＃＃＃＃＃＃＃＃＄＄＄＃＃＃＃＃＃＃＃＃＃＃＃＃＃＃＄＄＄＄＄＄＃＃＃＄＄＄＄＄＄＄＄＄＄＄＄＄＄＄＄＄＄＄＄＄＄＄＄＄＄＄＄＄＄＄＄＄＄＄＄＄＄＄＃＃＃
＃＃＃＄＄＄＃＃＃＄＄＄＃＃＃＄＄＄＃＃＃＄＄＄＃＃＃＄＄＄＃＃＃＄＄＄＃＃＃＄＄＄＃＃＃＄＄＄＃＃＃＃＃＃＃＃＃＄＄＄＃＃＃＄＄＄＄＄＄＃＃＃＃＃＃＃＃＃＄＄＄＄＄＄＄＄＄＃＃＃＃＃＃＃＃＃＄＄＄＄＄＄＃＃＃＠＠＠＃＃＃＃＃＃＃＃＃＃＃＃＃＃＃＃＃＃＃＃＃＃＃＃＃＃＃＃＃＃＃＃＃＃＃＃＃＃＃
＃＃＃＄＄＄＃＃＃＄＄＄＃＃＃＄＄＄＃＃＃＄＄＄＃＃＃＄＄＄＃＃＃＄＄＄＃＃＃＄＄＄＃＃＃＄＄＄＃＃＃＃＃＃＃＃＃＄＄＄＃＃＃＄＄＄＄＄＄＃＃＃＃＃＃＃＃＃＄＄＄＄＄＄＄＄＄＃＃＃＃＃＃＃＃＃＄＄＄＄＄＄＃＃＃＠＠＠＃＃＃＃＃＃＃＃＃＃＃＃＃＃＃＃＃＃＃＃＃＃＃＃＃＃＃＃＃＃＃＃＃＃＃＃＃＃＃
＃＃＃＄＄＄＃＃＃＄＄＄＃＃＃＄＄＄＃＃＃＄＄＄＃＃＃＄＄＄＃＃＃＄＄＄＃＃＃＄＄＄＃＃＃＄＄＄＃＃＃＃＃＃＃＃＃＄＄＄＃＃＃＄＄＄＄＄＄＃＃＃＃＃＃＃＃＃＄＄＄＄＄＄＄＄＄＃＃＃＃＃＃＃＃＃＄＄＄＄＄＄＃＃＃＠＠＠＃＃＃＃＃＃＃＃＃＃＃＃＃＃＃＃＃＃＃＃＃＃＃＃＃＃＃＃＃＃＃＃＃＃＃＃＃＃＃
＃＃＃＄＄＄＃＃＃＄＄＄＄＄＄＄＄＄＄＄＄＄＄＄＄＄＄＄＄＄＃＃＃＄＄＄＄＄＄＄＄＄＄＄＄＄＄＄＃＃＃＄＄＄＄＄＄＄＄＄＃＃＃＄＄＄＄＄＄＃＃＃＃＃＃＃＃＃＄＄＄＃＃＃＄＄＄＃＃＃＃＃＃＃＃＃＄＄＄＄＄＄＄＄＄＄＄＄＄＄＄＄＄＄＄＄＄＄＄＄＄＄＄＄＄＄＄＄＄＄＄＄＄＄＄＄＄＄＄＄＄＄＄＄＃＃＃
＃＃＃＄＄＄＃＃＃＄＄＄＄＄＄＄＄＄＄＄＄＄＄＄＄＄＄＄＄＄＃＃＃＄＄＄＄＄＄＄＄＄＄＄＄＄＄＄＃＃＃＄＄＄＄＄＄＄＄＄＃＃＃＄＄＄＄＄＄＃＃＃＃＃＃＃＃＃＄＄＄＃＃＃＄＄＄＃＃＃＃＃＃＃＃＃＄＄＄＄＄＄＄＄＄＄＄＄＄＄＄＄＄＄＄＄＄＄＄＄＄＄＄＄＄＄＄＄＄＄＄＄＄＄＄＄＄＄＄＄＄＄＄＄＃＃＃
＃＃＃＄＄＄＃＃＃＄＄＄＄＄＄＄＄＄＄＄＄＄＄＄＄＄＄＄＄＄＃＃＃＄＄＄＄＄＄＄＄＄＄＄＄＄＄＄＃＃＃＄＄＄＄＄＄＄＄＄＃＃＃＄＄＄＄＄＄＃＃＃＃＃＃＃＃＃＄＄＄＃＃＃＄＄＄＃＃＃＃＃＃＃＃＃＄＄＄＄＄＄＄＄＄＄＄＄＄＄＄＄＄＄＄＄＄＄＄＄＄＄＄＄＄＄＄＄＄＄＄＄＄＄＄＄＄＄＄＄＄＄＄＄＃＃＃
＃＃＃＄＄＄＃＃＃＄＄＄＃＃＃＄＄＄＃＃＃＃＃＃＃＃＃＄＄＄＃＃＃＄＄＄＃＃＃＃＃＃＃＃＃＄＄＄＃＃＃＄＄＄＃＃＃＃＃＃＃＃＃＄＄＄＄＄＄＃＃＃＃＃＃＃＃＃＄＄＄＃＃＃＄＄＄＄＄＄＄＄＄＃＃＃＄＄＄＄＄＄＃＃＃＃＃＃＃＃＃＃＃＃＃＃＃＃＃＃＃＃＃＃＃＃＃＃＃＃＃＃＃＃＃＃＃＃＃＃＃＄＄＄＃＃＃
＃＃＃＄＄＄＃＃＃＄＄＄＃＃＃＄＄＄＃＃＃＃＃＃＃＃＃＄＄＄＃＃＃＄＄＄＃＃＃＃＃＃＃＃＃＄＄＄＃＃＃＄＄＄＃＃＃＃＃＃＃＃＃＄＄＄＄＄＄＃＃＃＃＃＃＃＃＃＄＄＄＃＃＃＄＄＄＄＄＄＄＄＄＃＃＃＄＄＄＄＄＄＃＃＃＃＃＃＃＃＃＃＃＃＃＃＃＃＃＃＃＃＃＃＃＃＃＃＃＃＃＃＃＃＃＃＃＃＃＃＃＄＄＄＃＃＃
＃＃＃＄＄＄＃＃＃＄＄＄＃＃＃＄＄＄＃＃＃＃＃＃＃＃＃＄＄＄＃＃＃＄＄＄＃＃＃＃＃＃＃＃＃＄＄＄＃＃＃＄＄＄＃＃＃＃＃＃＃＃＃＄＄＄＄＄＄＃＃＃＃＃＃＃＃＃＄＄＄＃＃＃＄＄＄＄＄＄＄＄＄＃＃＃＄＄＄＄＄＄＃＃＃＃＃＃＃＃＃＃＃＃＃＃＃＃＃＃＃＃＃＃＃＃＃＃＃＃＃＃＃＃＃＃＃＃＃＃＃＄＄＄＃＃＃
＃＃＃＄＄＄＃＃＃＄＄＄＃＃＃＄＄＄＄＄＄＄＄＄＄＄＄＄＄＄＄＄＄＄＄＄＄＄＄＄＄＄＃＃＃＄＄＄＄＄＄＄＄＄＄＄＄＄＄＄＃＃＃＄＄＄＄＄＄＃＃＃＃＃＃＃＃＃＄＄＄＃＃＃＃＃＃＃＃＃＄＄＄＃＃＃＄＄＄＄＄＄＄＄＄＄＄＄＄＄＄＄＄＄＄＄＄＄＄＄＄＄＄＄＄＄＄＄＄＄＄＄＄＄＄＄＄＄＄＄＄＄＄＄＃＃＃
＃＃＃＄＄＄＃＃＃＄＄＄＃＃＃＄＄＄＄＄＄＄＄＄＄＄＄＄＄＄＄＄＄＄＄＄＄＄＄＄＄＄＃＃＃＄＄＄＄＄＄＄＄＄＄＄＄＄＄＄＃＃＃＄＄＄＄＄＄＃＃＃＃＃＃＃＃＃＄＄＄＃＃＃＃＃＃＃＃＃＄＄＄＃＃＃＄＄＄＄＄＄＄＄＄＄＄＄＄＄＄＄＄＄＄＄＄＄＄＄＄＄＄＄＄＄＄＄＄＄＄＄＄＄＄＄＄＄＄＄＄＄＄＄＃＃＃
＃＃＃＄＄＄＃＃＃＄＄＄＃＃＃＄＄＄＄＄＄＄＄＄＄＄＄＄＄＄＄＄＄＄＄＄＄＄＄＄＄＄＃＃＃＄＄＄＄＄＄＄＄＄＄＄＄＄＄＄＃＃＃＄＄＄＄＄＄＃＃＃＃＃＃＃＃＃＄＄＄＃＃＃＃＃＃＃＃＃＄＄＄＃＃＃＄＄＄＄＄＄＄＄＄＄＄＄＄＄＄＄＄＄＄＄＄＄＄＄＄＄＄＄＄＄＄＄＄＄＄＄＄＄＄＄＄＄＄＄＄＄＄＄＃＃＃
＃＃＃＄＄＄＃＃＃＄＄＄＃＃＃＃＃＃＃＃＃＄＄＄＃＃＃＄＄＄＃＃＃＃＃＃＃＃＃＄＄＄＃＃＃＄＄＄＃＃＃＃＃＃＃＃＃＠＠＠＃＃＃＄＄＄＄＄＄＃＃＃＃＃＃＃＃＃＄＄＄＃＃＃＄＄＄＄＄＄＄＄＄＃＃＃＄＄＄＄＄＄＄＄＄＄＄＄＄＄＄＄＄＄＄＄＄＄＄＄＄＄＄＄＄＄＄＄＄＄＄＄＄＄＄＄＄＄＄＄＄＄＄＄＃＃＃
＃＃＃＄＄＄＃＃＃＄＄＄＃＃＃＃＃＃＃＃＃＄＄＄＃＃＃＄＄＄＃＃＃＃＃＃＃＃＃＄＄＄＃＃＃＄＄＄＃＃＃＃＃＃＃＃＃＠＠＠＃＃＃＄＄＄＄＄＄＃＃＃＃＃＃＃＃＃＄＄＄＃＃＃＄＄＄＄＄＄＄＄＄＃＃＃＄＄＄＄＄＄＄＄＄＄＄＄＄＄＄＄＄＄＄＄＄＄＄＄＄＄＄＄＄＄＄＄＄＄＄＄＄＄＄＄＄＄＄＄＄＄＄＄＃＃＃
＃＃＃＄＄＄＃＃＃＄＄＄＃＃＃＃＃＃＃＃＃＄＄＄＃＃＃＄＄＄＃＃＃＃＃＃＃＃＃＄＄＄＃＃＃＄＄＄＃＃＃＃＃＃＃＃＃＠＠＠＃＃＃＄＄＄＄＄＄＃＃＃＃＃＃＃＃＃＄＄＄＃＃＃＄＄＄＄＄＄＄＄＄＃＃＃＄＄＄＄＄＄＄＄＄＄＄＄＄＄＄＄＄＄＄＄＄＄＄＄＄＄＄＄＄＄＄＄＄＄＄＄＄＄＄＄＄＄＄＄＄＄＄＄＃＃＃
＃＃＃＄＄＄＃＃＃＄＄＄＄＄＄＄＄＄＄＄＄＄＄＄＃＃＃＄＄＄＄＄＄＄＄＄＄＄＄＄＄＄＄＄＄＄＄＄＃＃＃＠＠＠＠＠＠＠＠＠＃＃＃＄＄＄＄＄＄＃＃＃＃＃＃＃＃＃＄＄＄＃＃＃＄＄＄＃＃＃＃＃＃＃＃＃＄＄＄＄＄＄＃＃＃＄＄＄＃＃＃＄＄＄＃＃＃＄＄＄＃＃＃＄＄＄＃＃＃＄＄＄＃＃＃＃＃＃＃＃＃＠＠＠＃＃＃
＃＃＃＄＄＄＃＃＃＄＄＄＄＄＄＄＄＄＄＄＄＄＄＄＃＃＃＄＄＄＄＄＄＄＄＄＄＄＄＄＄＄＄＄＄＄＄＄＃＃＃＠＠＠＠＠＠＠＠＠＃＃＃＄＄＄＄＄＄＃＃＃＃＃＃＃＃＃＄＄＄＃＃＃＄＄＄＃＃＃＃＃＃＃＃＃＄＄＄＄＄＄＃＃＃＄＄＄＃＃＃＄＄＄＃＃＃＄＄＄＃＃＃＄＄＄＃＃＃＄＄＄＃＃＃＃＃＃＃＃＃＠＠＠＃＃＃
＃＃＃＄＄＄＃＃＃＄＄＄＄＄＄＄＄＄＄＄＄＄＄＄＃＃＃＄＄＄＄＄＄＄＄＄＄＄＄＄＄＄＄＄＄＄＄＄＃＃＃＠＠＠＠＠＠＠＠＠＃＃＃＄＄＄＄＄＄＃＃＃＃＃＃＃＃＃＄＄＄＃＃＃＄＄＄＃＃＃＃＃＃＃＃＃＄＄＄＄＄＄＃＃＃＄＄＄＃＃＃＄＄＄＃＃＃＄＄＄＃＃＃＄＄＄＃＃＃＄＄＄＃＃＃＃＃＃＃＃＃＠＠＠＃＃＃
＃＃＃＄＄＄＃＃＃＃＃＃＃＃＃＄＄＄＃＃＃＃＃＃＃＃＃＄＄＄＃＃＃＄＄＄＃＃＃＃＃＃＃＃＃＄＄＄＃＃＃＠＠＠＠＠＠＠＠＠＃＃＃＠＠＠＠＠＠＃＃＃＃＃＃＃＃＃＄＄＄＃＃＃＄＄＄＄＄＄＄＄＄＃＃＃＄＄＄＄＄＄＃＃＃＄＄＄＃＃＃＄＄＄＃＃＃＄＄＄＃＃＃＄＄＄＃＃＃＄＄＄＃＃＃＠＠＠＠＠＠＠＠＠＃＃＃
＃＃＃＄＄＄＃＃＃＃＃＃＃＃＃＄＄＄＃＃＃＃＃＃＃＃＃＄＄＄＃＃＃＄＄＄＃＃＃＃＃＃＃＃＃＄＄＄＃＃＃＠＠＠＠＠＠＠＠＠＃＃＃＠＠＠＠＠＠＃＃＃＃＃＃＃＃＃＄＄＄＃＃＃＄＄＄＄＄＄＄＄＄＃＃＃＄＄＄＄＄＄＃＃＃＄＄＄＃＃＃＄＄＄＃＃＃＄＄＄＃＃＃＄＄＄＃＃＃＄＄＄＃＃＃＠＠＠＠＠＠＠＠＠＃＃＃
＃＃＃＄＄＄＃＃＃＃＃＃＃＃＃＄＄＄＃＃＃＃＃＃＃＃＃＄＄＄＃＃＃＄＄＄＃＃＃＃＃＃＃＃＃＄＄＄＃＃＃＠＠＠＠＠＠＠＠＠＃＃＃＠＠＠＠＠＠＃＃＃＃＃＃＃＃＃＄＄＄＃＃＃＄＄＄＄＄＄＄＄＄＃＃＃＄＄＄＄＄＄＃＃＃＄＄＄＃＃＃＄＄＄＃＃＃＄＄＄＃＃＃＄＄＄＃＃＃＄＄＄＃＃＃＠＠＠＠＠＠＠＠＠＃＃＃
＃＃＃＄＄＄＃＃＃＄＄＄＄＄＄＄＄＄＄＄＄＄＄＄＄＄＄＄＄＄＃＃＃＄＄＄＄＄＄＄＄＄＄＄＄＄＄＄＃＃＃＠＠＠＠＠＠＠＠＠＃＃＃＠＠＠＠＠＠＃＃＃＃＃＃＃＃＃＄＄＄＃＃＃＃＃＃＃＃＃＄＄＄＃＃＃＄＄＄＄＄＄＃＃＃＄＄＄＃＃＃＄＄＄＃＃＃＄＄＄＃＃＃＄＄＄＃＃＃＄＄＄＃＃＃＠＠＠＠＠＠＠＠＠＃＃＃
＃＃＃＄＄＄＃＃＃＄＄＄＄＄＄＄＄＄＄＄＄＄＄＄＄＄＄＄＄＄＃＃＃＄＄＄＄＄＄＄＄＄＄＄＄＄＄＄＃＃＃＠＠＠＠＠＠＠＠＠＃＃＃＠＠＠＠＠＠＃＃＃＃＃＃＃＃＃＄＄＄＃＃＃＃＃＃＃＃＃＄＄＄＃＃＃＄＄＄＄＄＄＃＃＃＄＄＄＃＃＃＄＄＄＃＃＃＄＄＄＃＃＃＄＄＄＃＃＃＄＄＄＃＃＃＠＠＠＠＠＠＠＠＠＃＃＃
＃＃＃＄＄＄＃＃＃＄＄＄＄＄＄＄＄＄＄＄＄＄＄＄＄＄＄＄＄＄＃＃＃＄＄＄＄＄＄＄＄＄＄＄＄＄＄＄＃＃＃＠＠＠＠＠＠＠＠＠＃＃＃＠＠＠＠＠＠＃＃＃＃＃＃＃＃＃＄＄＄＃＃＃＃＃＃＃＃＃＄＄＄＃＃＃＄＄＄＄＄＄＃＃＃＄＄＄＃＃＃＄＄＄＃＃＃＄＄＄＃＃＃＄＄＄＃＃＃＄＄＄＃＃＃＠＠＠＠＠＠＠＠＠＃＃＃
＃＃＃＄＄＄＃＃＃＄＄＄＃＃＃＃＃＃＃＃＃＃＃＃＃＃＃＃＃＃＃＃＃＄＄＄＃＃＃＃＃＃＃＃＃＄＄＄＃＃＃＃＃＃＃＃＃＃＃＃＃＃＃＠＠＠＠＠＠＃＃＃＃＃＃＃＃＃＄＄＄＄＄＄＄＄＄＄＄＄＄＄＄＃＃＃＄＄＄＄＄＄＄＄＄＄＄＄＄＄＄＄＄＄＄＄＄＄＄＄＄＄＄＄＄＄＄＄＄＄＄＄＃＃＃＠＠＠＠＠＠＠＠＠＃＃＃
＃＃＃＄＄＄＃＃＃＄＄＄＃＃＃＃＃＃＃＃＃＃＃＃＃＃＃＃＃＃＃＃＃＄＄＄＃＃＃＃＃＃＃＃＃＄＄＄＃＃＃＃＃＃＃＃＃＃＃＃＃＃＃＠＠＠＠＠＠＃＃＃＃＃＃＃＃＃＄＄＄＄＄＄＄＄＄＄＄＄＄＄＄＃＃＃＄＄＄＄＄＄＄＄＄＄＄＄＄＄＄＄＄＄＄＄＄＄＄＄＄＄＄＄＄＄＄＄＄＄＄＄＃＃＃＠＠＠＠＠＠＠＠＠＃＃＃
＃＃＃＄＄＄＃＃＃＄＄＄＃＃＃＃＃＃＃＃＃＃＃＃＃＃＃＃＃＃＃＃＃＄＄＄＃＃＃＃＃＃＃＃＃＄＄＄＃＃＃＃＃＃＃＃＃＃＃＃＃＃＃＃＃＃＃＃＃＃＃＃＃＃＃＃＃＃＄＄＄＄＄＄＄＄＄＄＄＄＄＄＄＃＃＃＄＄＄＄＄＄＄＄＄＄＄＄＄＄＄＄＄＄＄＄＄＄＄＄＄＄＄＄＄＄＄＄＄＄＄＄＃＃＃＠＠＠＠＠＠＠＠＠＃＃＃
＃＃＃＄＄＄＄＄＄＄＄＄＄＄＄＄＄＄＄＄＄＄＄＄＄＄＄＄＄＄＄＄＄＄＄＄＄＄＄＄＄＄＄＄＄＄＄＄＃＃＃＃＃＃＃＃＃＃＃＃＃＃＃＃＃＃＃＃＃＃＃＃＃＃＃＃＃＃＃＃＃＃＃＃＃＃＃＃＃＃＃＃＃＃＃＃＃＃＃＃＃＃＃＃＃＃＃＃＃＃＃＃＃＃＃＃＃＃＃＃＃＃＃＃＃＃＃＃＃＃＃＃＃＃＃＃＃＃＃＃＃＃＃＃＃＃＃
＃＃＃＄＄＄＄＄＄＄＄＄＄＄＄＄＄＄＄＄＄＄＄＄＄＄＄＄＄＄＄＄＄＄＄＄＄＄＄＄＄＄＄＄＄＄＄＄＃＃＃＃＃＃＃＃＃＃＃＃＃＃＃＃＃＃＃＃＃＃＃＃＃＃＃＃＃＃＃＃＃＃＃＃＃＃＃＃＃＃＃＃＃＃＃＃＃＃＃＃＃＃＃＃＃＃＃＃＃＃＃＃＃＃＃＃＃＃＃＃＃＃＃＃＃＃＃＃＃＃＃＃＃＃＃＃＃＃＃＃＃＃＃＃＃＃＃
＃＃＃＄＄＄＄＄＄＄＄＄＄＄＄＄＄＄＄＄＄＄＄＄＄＄＄＄＄＄＄＄＄＄＄＄＄＄＄＄＄＄＄＄＄＄＄＄＃＃＃＃＃＃＃＃＃＃＃＃＃＃＃＃＃＃＃＃＃＃＃＃＃＃＃＃＃＃＃＃＃＃＃＃＃＃＃＃＃＃＃＃＃＃＃＃＃＃＃＃＃＃＃＃＃＃＃＃＃＃＃＃＃＃＃＃＃＃＃＃＃＃＃＃＃＃＃＃＃＃＃＃＃＃＃＃＃＃＃＃＃＃＃＃＃＃＃
＃＃＃＃＃＃＃＃＃＃＃＃＃＃＃＃＃＃＃＃＃＃＃＃＃＃＃＃＃＃＃＃＃＃＃＃＃＃＃＃＃＃＃＃＃＃＃＃＃＃＃＃＃＃＃＃＃＃＃＃＃＃＃＃＃＃＃＃＃＃＃＃＃＃＃＃＃＃＃＃＃＃＃＃＃＃＃＃＃＃＃＃＃＃＃＃＃＃＃＃＃＃＃＃＃＃＃＃＃＃＃＃＃＃＃＃＃＃＃＃＃＃＃＃＃＃＃＃＃＃＃＃＃＃＃＃＃＃＃＃＃＃＃＃＃＃＃
＃＃＃＃＃＃＃＃＃＃＃＃＃＃＃＃＃＃＃＃＃＃＃＃＃＃＃＃＃＃＃＃＃＃＃＃＃＃＃＃＃＃＃＃＃＃＃＃＃＃＃＃＃＃＃＃＃＃＃＃＃＃＃＃＃＃＃＃＃＃＃＃＃＃＃＃＃＃＃＃＃＃＃＃＃＃＃＃＃＃＃＃＃＃＃＃＃＃＃＃＃＃＃＃＃＃＃＃＃＃＃＃＃＃＃＃＃＃＃＃＃＃＃＃＃＃＃＃＃＃＃＃＃＃＃＃＃＃＃＃＃＃＃＃＃＃＃
＃＃＃＃＃＃＃＃＃＃＃＃＃＃＃＃＃＃＃＃＃＃＃＃＃＃＃＃＃＃＃＃＃＃＃＃＃＃＃＃＃＃＃＃＃＃＃＃＃＃＃＃＃＃＃＃＃＃＃＃＃＃＃＃＃＃＃＃＃＃＃＃＃＃＃＃＃＃＃＃＃＃＃＃＃＃＃＃＃＃＃＃＃＃＃＃＃＃＃＃＃＃＃＃＃＃＃＃＃＃＃＃＃＃＃＃＃＃＃＃＃＃＃＃＃＃＃＃＃＃＃＃＃＃＃＃＃＃＃＃＃＃＃＃＃＃＃