11111111111111111111111111111111111111111111111111111111111111111111111111111111111111111111111111111111111111111111111111111111111111111111
11111111111111111111111111111111111111111111111111111111111111111111111111111111111111111111118888888888888888888888888888888888888888888881
11111111111111111111111111111111111111111111111111111111111111111111111111111111111111111111118888888888888888888888888888888888888888888881
11111111111111111111111111111111111111111111111111111111111111111111111111111111111111111111118888888888888888888888888888888888888888888881
18888888881118888888888888888888888888888888888881118888888888888881111111111111111111111111118881111111118881111111111111111111118881118881
18888888881118888888888888888888888888888888888881118888888888888881111111111111111111111111118881111111118881111111111111111111118881118881
18888888881118888888888888888888888888888888888881118888888888888881111111111111111111111111118881111111118881111111111111111111118881118881
18888888881118881118881118881118881118881118888881118881111111118881111118888881118888888881118888888888888881118888888888888888888881118881
18888588881118881118881118881118881118881118888881118881111111118881111118888881118888888881118888888888888881118888888888888888888881118881
18888888881118881118881118881118881118881118888881118881111111118881111118888881118888888881118888888888888881118888888888888888888881118881
18888888881118881118881118881118881118881118888881118888888881118881111118888881118888888881118881111111118881118881111111118881111111118881
18888888881118881118881118881118881118881118888881118888888881118881111118888881118888588881118881111111118881118881111111118881111111118881
18888888881118881118881118881118881118881118888881118888888881118881111118888881118888888881118881111111118881118881111111118881111111118881
18881111111118881118881118881118881118881118888881111111118881118881111118888881118888888881118888888888888888888881118888888888888881118881
18881111111118881118881118881118881118881118888881111111118881118881111118888881118888888881118888888888888888888881118888888888888881118881
18881111111118881118881118881118881118881118888881111111118881118881111118888881118888888881118888888888888888888881118888888888888881118881
18888888888888888888888888888888888888888888888881118888888881118881111118888881118881111111118881118881111111118881118881111111118881118881
18888888888888888888888888888888888888888888888881118888888881118881111118888881118881111111118881118881111111118881118881111111118881118881
18888888888888888888888888888888888888888888888881118888888881118881111118888881118881111111118881118881111111118881118881111111118881118881
18888888888888888888888888888888888888888888888881118881111111118881111118888881118888888888888881118888888888888888888888888881118881118881
18888888888888888888888888888888888888888888888881118881111111118881111118888881118888888888888881118888888888888888888888888881118881118881
18888888888888888888888888888888888888888888888881118881111111118881111118888881118888888888888881118888888888888888888888888881118881118881
18881111111111111111111111111111111111111118888881118888888881118881111118888881111111118881118881111111118881118881111111118881118881118881
18881111111111111111111111111111111111111118888881118888888881118881111118888881111111118881118881111111118881118881111111118881118881118881
18881111111111111111111111111111111111111118888881118888888881118881111118888881111111118881118881111111118881118881111111118881118881118881
18888888888888888888888888888888888888888888888881111111118881118881111118888881118888888881118888888888888881118888888888888888888881118881
18888888888888888888888888888888888888888888888881111111118881118881111118888881118888888881118888888888888881118888888888888888888881118881
18888888888888888888888888888888888888888888888881111111118881118881111118888881118888888881118888888888888881118888888888888888888881118881
11111111111111111111111111111111111118881118888881111111118888888881111118888881118881111111118881118881118881118881118881118881118881118881
11111111111111111111111111111111111118881118888881111111118888888881111118888881118881111111118881118881118881118881118881118881118881118881
11111111111111111111111111111111111118881118888881111111118888888881111118888881118881111111118881118881118881118881118881118881118881118881
18888888888888888888888888888888888888881118888881111111111111118881111118888881118888888888888888888881118888888881118881118888888881118881
18888888888888888888888888888888888888881118888881111111111111118881111118888881118888888888888888888881118888888881118881118888888881118881
18888888888888888888888888888888888888881118888881111111111111118881111118888881118888888888888888888881118888888881118881118888888881118881
18881118881118881118881118881118881118881118888881118888888881118881111118888881111111118881111111118881118881118881118881118881118881118881
18881118881118881118881118881118881118881118888881118888888881118881111118888881111111118881111111118881118881118881118881118881118881118881
18881118881118881118881118881118881118881118888881118888888881118881111118888881111111118881111111118881118881118881118881118881118881118881
18888888888888888888888888888888888888881118888888888888888881118881111118888888888888888881118888888881118888888888888881118881118881118881
18888888888888888888888888888888888888881118888888888888588881118881111118888888888888888881118888888881118888888888888881118881118881118881
18888888888888888888888888888888888888881118888888888888888881118881111118888888888888888881118888888881118888888888888881118881118881118881
18881118881118881118881118881118881118881118888881118888888881118881111118888881118881118881118881111111111111118881111111118881118881118881
18881118881118881118881118881118881118881118888881118888888881118881111118888881118881118881118881111111111111118881111111118881118881118881
18881118881118881118881118881118881118881118888881118888888881118881111118888881118881118881118881111111111111118881111111118881118881118881
18888888888888888888888888888888888888881118888881111111111111118881111118888881118888888888888888888888888888888888888888888881118888888881
18888888888888888888888888888888888888881118888881111111111111118881111118888881118888888888888888888888888888888888888888888881118888888881
18888888888888888888888888888888888888881118888881111111111111118881111118888881118888888888888888888888888888888888888888888881118888888881
18881118881118881118881118881118881118881118888881111111111111118881111118888881111111111111111111111111111111111111111111111111118881111111
18881118881118881118881118881118881118881118888881111111111111118881111118888881111111111111111111111111111111111111111111111111118881111111
18881118881118881118881118881118881118881118888881111111111111118881111118888881111111111111111111111111111111111111111111111111118881111111
18888888888888888888888888888888888888888888888888888888888888888888888888888888888888888888888888888888888888888888888888888888888888888881
18888888888888888888888888888888888888888888888888888888888888888888888888888888888888888888888888888888888888888888888888888888888888888881
18888888888888888888888888888888888888888888888888888888888888888888888888888888888888888888888888888888888888888888888888888888888888888881
18888888888888888888888888888888888888888888888888888888888888888888888888888888888888888888888888888888888888888888888888888888888888888881
11111118881111111111111111111111111111111111111111111111111118888881111118881111111111111118888881118881118881118881118881118881118881118881
11111118881111111111111111111111111111111111111111111111111118888881111118881111111111111118888881118881118881118881118881118881118881118881
11111118881111111111111111111111111111111111111111111111111118888881111118881111111111111118888881118881118881118881118881118881118881118881
18888888881118888888888888888888888888888888888888888888881118888881111118881111111111111118888881118888888888888888888888888888888888888881
18888888881118888888888888888888888888888888888888888888881118888881111118881111111111111118888881118888888888888888888888888888888888888881
18888888881118888888888888888888888888888888888888888888881118888881111118881111111111111118888881118888888888888888888888888888888888888881
18881118881118881111111118881111111111111118881118881118881118888881111118881118888888881118888881118881118881118881118881118881118881118881
18881118881118881111111118881111111111111118881118881118881118888881111118881118888888881118888881118881118881118881118881118881118881118881
18881118881118881111111118881111111111111118881118881118881118888881111118881118888888881118888881118881118881118881118881118881118881118881
18881118881118881118888888888888881118888888881118888888888888888881111118881118888888888888888881118888888888888888888888888888888888888881
18881118881118881118888888888888881118888888881118888888888888888881111118881118888588888888888881118888888888888888888888888888888888888881
18881118881118881118888888888888881118888888881118888888888888888881111118881118888888888888888881118888888888888888888888888888888888888881
18881118881118881118881118881118881118881111111118881111111118888881111118881118888888881118888881118881118881118881118881118881118881118881
18881118881118881118881118881118881118881111111118881111111118888881111118881118888888881118888881118881118881118881118881118881118881118881
18881118881118881118881118881118881118881111111118881111111118888881111118881118888888881118888881118881118881118881118881118881118881118881
18881118888888881118881118888888881118888888888888888888881118888881111118881111111111111118888881118888888888888888888888888888888888888881
18881118888888881118881118888888881118888888888888888888881118888881111118881111111111111118888881118888888888888888888888888888888888888881
18881118888888881118881118888888881118888888888888888888881118888881111118881111111111111118888881118888888888888888888888888888888888888881
18881118881118881118881118881118881118881118881111111118881118888881111118888888881111111118888881118881111111111111111111111111111111111111
18881118881118881118881118881118881118881118881111111118881118888881111118888888881111111118888881118881111111111111111111111111111111111111
18881118881118881118881118881118881118881118881111111118881118888881111118888888881111111118888881118881111111111111111111111111111111111111
18881118888888888888888888881118888888888888881118888888881118888881111118881118881111111118888888888888888888888888888888888888888888888881
18881118888888888888888888881118888888888888881118888888881118888881111118881118881111111118888888888888888888888888888888888888888888888881
18881118888888888888888888881118888888888888881118888888881118888881111118881118881111111118888888888888888888888888888888888888888888888881
18881118881118881111111118881118881111111118881118881111111118888881111118881118888888881118888881111111111111111111111111111111111111118881
18881118881118881111111118881118881111111118881118881111111118888881111118881118888888881118888881111111111111111111111111111111111111118881
18881118881118881111111118881118881111111118881118881111111118888881111118881118888888881118888881111111111111111111111111111111111111118881
18881118881118888888888888888888888888881118888888888888881118888881111118881111111118881118888888888888888888888888888888888888888888888881
18881118881118888888888888888888888888881118888888888888881118888881111118881111111118881118888888888888888888888888888888888888888888888881
18881118881118888888888888888888888888881118888888888888881118888881111118881111111118881118888888888888888888888888888888888888888888888881
18881118881111111118881118881111111118881118881111111118881118888881111118881118888888881118888888888888888888888888888888888888888888888881
18881118881111111118881118881111111118881118881111111118881118888881111118881118888888881118888888888888888888888888888888888888888888888881
18881118881111111118881118881111111118881118881111111118881118888881111118881118888888881118888888888888888888888888888888888888888888888881
18881118888888888888881118888888888888888888881118888888881118888881111118881118881111111118888881118881118881118881118881118881111111118881
18881118888888888888881118888888888888888888881118888888881118888881111118881118881111111118888881118881118881118881118881118881111111118881
18881118888888888888881118888888888888888888881118888888881118888881111118881118881111111118888881118881118881118881118881118881111111118881
18881111111118881111111118881118881111111118881118888888881118888881111118881118888888881118888881118881118881118881118881118881118888888881
18881111111118881111111118881118881111111118881118888588881118888881111118881118888888881118888881118881118881118881118881118881118888888881
18881111111118881111111118881118881111111118881118888888881118888881111118881118888888881118888881118881118881118881118881118881118888888881
18881118888888888888888888881118888888888888881118888888881118888881111118881111111118881118888881118881118881118881118881118881118888888881
18881118888888888888888888881118888888888888881118888888881118888881111118881111111118881118888881118881118881118881118881118881118888588881
18881118888888888888888888881118888888888888881118888888881118888881111118881111111118881118888881118881118881118881118881118881118888888881
18881118881111111111111111111118881111111118881111111111111111111111111118888888888888881118888888888888888888888888888888888881118888888881
18881118881111111111111111111118881111111118881111111111111111111111111118888888888888881118888888888888888888888888888888888881118888888881
18881118881111111111111111111118881111111118881111111111111111111111111118888888888888881118888888888888888888888888888888888881118888888881
18888888888888888888888888888888888888888888881111111111111111111111111111111111111111111111111111111111111111111111111111111111111111111111
18888888888888888888888888888888888888888888881111111111111111111111111111111111111111111111111111111111111111111111111111111111111111111111
18888888888888888888888888888888888888888888881111111111111111111111111111111111111111111111111111111111111111111111111111111111111111111111
11111111111111111111111111111111111111111111111111111111111111111111111111111111111111111111111111111111111111111111111111111111111111111111
