111111111111111111111111111111111111111111111111111111111111111111111111111111111111111111111111111111111111111111111111111111111111111111111111111
111111111111111111111111111111111111111111111111111111111111111111111111111111111111111111111111111111111111111111111111111111111111111111111111111
111111111111111111111111111111111111111111111111111111111111111111111111111111111111111111111111111111111111111111111111111111111111111111111111111
111111111111111111111111111111111111111111111111111111111111111111111111111111111111111111111111111888888888888888888888888888888888888888888888111
111111111111111111111111111111111111111111111111111111111111111111111111111111111111111111111111111888888888888888888888888888888888888888888888111
111111111111111111111111111111111111111111111111111111111111111111111111111111111111111111111111111888888888888888888888888888888888888888888888111
111888888888111888888888888888888888888888888888888111888888888888888111111111111111111111111111111888111111111888111111111111111111111888111888111
111888888888111888888888888888888888888888888888888111888888888888888111111111888888111111111111111888111111111888111111111111111111111888111888111
111888888888111888888888888888888888888888888888888111888888888888888111111111888888111111111111111888111111111888111111111111111111111888111888111
111888888888111888111888111888111888111888111888888111888111111111888111111111888888111888888888111888888888888888111888888888888888888888111888111
111888888888111888111888111888111888111888111888888111888111111111888111111111888888111888888888111888888888888888111888888888888888888888111888111
111888888888111888111888111888111888111888111888888111888111111111888111111111888888111888888888111888888888888888111888888888888888888888111888111
111888888888111888111888111888111888111888111888888111888888888111888111111111888888111888888888111888111111111888111888111111111888111111111888111
111888888888111888111888111888111888111888111888888111888888888111888111111111888888111888888888111888111111111888111888111111111888111111111888111
111888888888111888111888111888111888111888111888888111888888888111888111111111888888111888888888111888111111111888111888111111111888111111111888111
111888111111111888111888111888111888111888111888888111111111888111888111111111888888111888888888111888888888888888888888111888888888888888111888111
111888111111111888111888111888111888111888111888888111111111888111888111111111888888111888888888111888888888888888888888111888888888888888111888111
111888111111111888111888111888111888111888111888888111111111888111888111111111888888111888888888111888888888888888888888111888888888888888111888111
111888888888888888888888888888888888888888888888888111888888888111888111111111888888111888111111111888111888111111111888111888111111111888111888111
111888888888888888888888888888888888888888888888888111888888888111888111111111888888111888111111111888111888111111111888111888111111111888111888111
111888888888888888888888888888888888888888888888888111888888888111888111111111888888111888111111111888111888111111111888111888111111111888111888111
111888888888888888888888888888888888888888888888888111888111111111888111111111888888111888888888888888111888888888888888888888888888111888111888111
111888888888888888888888888888888888888888888888888111888111111111888111111111888888111888888888888888111888888888888888888888888888111888111888111
111888888888888888888888888888888888888888888888888111888111111111888111111111888888111888888888888888111888888888888888888888888888111888111888111
111888111111111111111111111111111111111111111888888111888888888111888111111111888888111111111888111888111111111888111888111111111888111888111888111
111888111111111111111111111111111111111111111888888111888888888111888111111111888888111111111888111888111111111888111888111111111888111888111888111
111888111111111111111111111111111111111111111888888111888888888111888111111111888888111111111888111888111111111888111888111111111888111888111888111
111888888888888888888888888888888888888888888888888111111111888111888111111111888888111888888888111888888888888888111888888888888888888888111888111
111888888888888888888888888888888888888888888888888111111111888111888111111111888888111888888888111888888888888888111888888888888888888888111888111
111888888888888888888888888888888888888888888888888111111111888111888111111111888888111888888888111888888888888888111888888888888888888888111888111
111111111111111111111111111111111111111888111888888111111111888888888111111111888888111888111111111888111888111888111888111888111888111888111888111
111111111111111111111111111111111111111888111888888111111111888888888111111111888888111888111111111888111888111888111888111888111888111888111888111
111111111111111111111111111111111111111888111888888111111111888888888111111111888888111888111111111888111888111888111888111888111888111888111888111
111888888888888888888888888888888888888888111888888111111111111111888111111111888888111888888888888888888888111888888888111888111888888888111888111
111888888888888888888888888888888888888888111888888111111111111111888111111111888888111888888888888888888888111888888888111888111888888888111888111
111888888888888888888888888888888888888888111888888111111111111111888111111111888888111888888888888888888888111888888888111888111888888888111888111
111888111888111888111888111888111888111888111888888111888888888111888111111111888888111111111888111111111888111888111888111888111888111888111888111
111888111888111888111888111888111888111888111888888111888888888111888111111111888888111111111888111111111888111888111888111888111888111888111888111
111888111888111888111888111888111888111888111888888111888888888111888111111111888888111111111888111111111888111888111888111888111888111888111888111
111888888888888888888888888888888888888888111888888888888888888111888111111111888888888888888888111888888888111888888888888888111888111888111888111
111888888888888888888888888888888888888888111888888888888888888111888111111111888888888888888888111888888888111888888888888888111888111888111888111
111888888888888888888888888888888888888888111888888888888888888111888111111111888888888888888888111888888888111888888888888888111888111888111888111
111888111888111888111888111888111888111888111888888111888888888111888111111111888888111888111888111888111111111111111888111111111888111888111888111
111888111888111888111888111888111888111888111888888111888888888111888111111111888888111888111888111888111111111111111888111111111888111888111888111
111888111888111888111888111888111888111888111888888111888888888111888111111111888888111888111888111888111111111111111888111111111888111888111888111
111888888888888888888888888888888888888888111888888111111111111111888111111111888888111888888888888888888888888888888888888888888888111888888888111
111888888888888888888888888888888888888888111888888111111111111111888111111111888888111888888888888888888888888888888888888888888888111888888888111
111888888888888888888888888888888888888888111888888111111111111111888111111111888888111888888888888888888888888888888888888888888888111888888888111
111888111888111888111888111888111888111888111888888111111111111111888111111111888888111111111111111111111111111111111111111111111111111888111111111
111888111888111888111888111888111888111888111888888111111111111111888111111111888888111111111111111111111111111111111111111111111111111888111111111
111888111888111888111888111888111888111888111888888111111111111111888111111111888888111111111111111111111111111111111111111111111111111888111111111
111888888888888888888888888888888888888888888888888888888888888888888888888888888888888888888888888888888888888888888888888888888888888888888888111
111888888888888888888888888888888888888888888888888888888888888888888888888888888888888888888888888888888888888888888888888888888888888888888888111
111888888888888888888888888888888888888888888888888888888888888888888888888888888888888888888888888888888888888888888888888888888888888888888888111
111888888888888888888888888888888888888888888888888888888888888888888888888888888888888888888888888888888888888888888888888888888888888888888888111
111888888888888888888888888888888888888888888888888888888888888888888888888888888888888888888888888888888888888888888888888888888888888888888888111
111888888888888888888888888888888888888888888888888888888888888888888888888888888888888888888888888888888888888888888888888888888888888888888888111
111888888888888888888888888888888888888888888888888888888888888888888888888888888888888888888888888888888888888888888888888888888888888888888888111
111888888888888888888888888888888888888888888888888888888888888888888888888888888888888888888888888888888888888888888888888888888888888888888888111
111888888888888888888888888888888888888888888888888888888888888888888888888888888888888888888888888888888888888888888888888888888888888888888888111
111111111888111111111111111111111111111111111111111111111111111888888111111111888111111111111111888888111888111888111888111888111888111888111888111
111111111888111111111111111111111111111111111111111111111111111888888111111111888111111111111111888888111888111888111888111888111888111888111888111
111111111888111111111111111111111111111111111111111111111111111888888111111111888111111111111111888888111888111888111888111888111888111888111888111
111888888888111888888888888888888888888888888888888888888888111888888111111111888111111111111111888888111888888888888888888888888888888888888888111
111888888888111888888888888888888888888888888888888888888888111888888111111111888111111111111111888888111888888888888888888888888888888888888888111
111888888888111888888888888888888888888888888888888888888888111888888111111111888111111111111111888888111888888888888888888888888888888888888888111
111888111888111888111111111888111111111111111888111888111888111888888111111111888111888888888111888888111888111888111888111888111888111888111888111
111888111888111888111111111888111111111111111888111888111888111888888111111111888111888888888111888888111888111888111888111888111888111888111888111
111888111888111888111111111888111111111111111888111888111888111888888111111111888111888888888111888888111888111888111888111888111888111888111888111
111888111888111888111888888888888888111888888888111888888888888888888111111111888111888888888888888888111888888888888888888888888888888888888888111
111888111888111888111888888888888888111888888888111888888888888888888111111111888111888888888888888888111888888888888888888888888888888888888888111
111888111888111888111888888888888888111888888888111888888888888888888111111111888111888888888888888888111888888888888888888888888888888888888888111
111888111888111888111888111888111888111888111111111888111111111888888111111111888111888888888111888888111888111888111888111888111888111888111888111
111888111888111888111888111888111888111888111111111888111111111888888111111111888111888888888111888888111888111888111888111888111888111888111888111
111888111888111888111888111888111888111888111111111888111111111888888111111111888111888888888111888888111888111888111888111888111888111888111888111
111888111888888888111888111888888888111888888888888888888888111888888111111111888111111111111111888888111888888888888888888888888888888888888888111
111888111888888888111888111888888888111888888888888888888888111888888111111111888111111111111111888888111888888888888888888888888888888888888888111
111888111888888888111888111888888888111888888888888888888888111888888111111111888111111111111111888888111888888888888888888888888888888888888888111
111888111888111888111888111888111888111888111888111111111888111888888111111111888888888111111111888888111888111111111111111111111111111111111111111
111888111888111888111888111888111888111888111888111111111888111888888111111111888888888111111111888888111888111111111111111111111111111111111111111
111888111888111888111888111888111888111888111888111111111888111888888111111111888888888111111111888888111888111111111111111111111111111111111111111
111888111888888888888888888888111888888888888888111888888888111888888111111111888111888111111111888888888888888888888888888888888888888888888888111
111888111888888888888888888888111888888888888888111888888888111888888111111111888111888111111111888888888888888888888888888888888888888888888888111
111888111888888888888888888888111888888888888888111888888888111888888111111111888111888111111111888888888888888888888888888888888888888888888888111
111888111888111888111111111888111888111111111888111888111111111888888111111111888111888888888111888888111111111111111111111111111111111111111888111
111888111888111888111111111888111888111111111888111888111111111888888111111111888111888888888111888888111111111111111111111111111111111111111888111
111888111888111888111111111888111888111111111888111888111111111888888111111111888111888888888111888888111111111111111111111111111111111111111888111
111888111888111888888888888888888888888888111888888888888888111888888111111111888111111111888111888888888888888888888888888888888888888888888888111
111888111888111888888888888888888888888888111888888888888888111888888111111111888111111111888111888888888888888888888888888888888888888888888888111
111888111888111888888888888888888888888888111888888888888888111888888111111111888111111111888111888888888888888888888888888888888888888888888888111
111888111888111111111888111888111111111888111888111111111888111888888111111111888111888888888111888888888888888888888888888888888888888888888888111
111888111888111111111888111888111111111888111888111111111888111888888111111111888111888888888111888888888888888888888888888888888888888888888888111
111888111888111111111888111888111111111888111888111111111888111888888111111111888111888888888111888888888888888888888888888888888888888888888888111
111888111888888888888888111888888888888888888888111888888888111888888111111111888111888111111111888888111888111888111888111888111888111111111888111
111888111888888888888888111888888888888888888888111888888888111888888111111111888111888111111111888888111888111888111888111888111888111111111888111
111888111888888888888888111888888888888888888888111888888888111888888111111111888111888111111111888888111888111888111888111888111888111111111888111
111888111111111888111111111888111888111111111888111888888888111888888111111111888111888888888111888888111888111888111888111888111888111888888888111
111888111111111888111111111888111888111111111888111888888888111888888111111111888111888888888111888888111888111888111888111888111888111888888888111
111888111111111888111111111888111888111111111888111888888888111888888111111111888111888888888111888888111888111888111888111888111888111888888888111
111888111888888888888888888888111888888888888888111888888888111888888111111111888111111111888111888888111888111888111888111888111888111888888888111
111888111888888888888888888888111888888888888888111888888888111888888111111111888111111111888111888888111888111888111888111888111888111888888888111
111888111888888888888888888888111888888888888888111888888888111888888111111111888111111111888111888888111888111888111888111888111888111888888888111
111888111888111111111111111111111888111111111888111111111111111888888111111111888888888888888111888888888888888888888888888888888888111888888888111
111888111888111111111111111111111888111111111888111111111111111888888111111111888888888888888111888888888888888888888888888888888888111888888888111
111888111888111111111111111111111888111111111888111111111111111111111111111111888888888888888111888888888888888888888888888888888888111888888888111
111888888888888888888888888888888888888888888888111111111111111111111111111111111111111111111111111111111111111111111111111111111111111111111111111
111888888888888888888888888888888888888888888888111111111111111111111111111111111111111111111111111111111111111111111111111111111111111111111111111
111888888888888888888888888888888888888888888888111111111111111111111111111111111111111111111111111111111111111111111111111111111111111111111111111
111111111111111111111111111111111111111111111111111111111111111111111111111111111111111111111111111111111111111111111111111111111111111111111111111
111111111111111111111111111111111111111111111111111111111111111111111111111111111111111111111111111111111111111111111111111111111111111111111111111
111111111111111111111111111111111111111111111111111111111111111111111111111111111111111111111111111111111111111111111111111111111111111111111111111